/*
Created by alexanderfedchin on 17/11/18.
This is the complete scansion of trimeter sections of Dati's Hiemsal
The edition used is Grund (2011)
Estimated accuracy: 98%

Each line contains a verse from the original text, a list of words from that
verse with their inferred scansions, the scansion itself, and one of the
following tags:
    'm' - if the line was manually scanned
    'v' - if automatically produced scansion was manually verified
    'c' - if automatically produced scansion was corrected
    'u' - if the line was left unscanned
    confidence score that the program assigns to the line (higher=better)

Key:
X - monosyllabic anceps (can also be marked as _ or ^ wherever the line is
	scanned manually)
_ - long syllable
^ - short syllable
& - the quantity is unknown (for elided syllables, anceps syllables,
	or syllables long by position)
Note that there are 2 lines that are not scanned
Resolution rate: 0.83
Resolution rate in lines in which speakers remain the same: 0.826
Resolution rate in lines in which speakers change: 0.944
*/

Ad dulce praesidium meum, ad certum domus	a&d du_lce& pr[ae]si^di^u&m me&u&m a&d ce&rtu&m do^mu&s 	X_X_^^_X_X_^X	1.0
altae Columnae et unicum Romae decus,	a&lt[ae] co&lu_mn[ae] e&t u_ni&cu&m ro&m[ae] de^cu&s 	X_X_X_X_X_^X	1.0
ad Prosperum tendes, Hyempsal, et pede	a&d pro_spe^ru&m te&nde&s hy^e_mpsa&l e&t pe^de& 	X_X_X_X_X_^X	v
grandi. At licet nec compta nec forsan ferax	gra&ndi& a&t li&ce&t ne&c co_mpta& ne&c fo&rsa&n fe^ra&x 	X_X_X_X_X_^X	1.0
sententiis, ut decet, ei tamen, ut reor,	se_nte_nti^i_s, u&t de^ce^t, e^i_ ta^me^n, u&t re^o^r, 	X_X_X^^X_^^_^X	m
quoniam mea es, futura grata principi:	qvo^ni^a&m me&a& e&s fu&tu_ra& gra_ta& pri_nci^pi& 	^^_X_X_X_X_^X	1.0
nam et mitis est et me Dathum valde probat.	na&m e&t mi_ti^s e&st e&t me_ da_thu&m va&lde& pro^ba&t 	X_X_X_X_X_^X	v
Tum pande quanti est invidia tenax mali,	tu&m pa_nde& qva_nti& e&st i_nvi&di^a^ te&na&x ma^li& 	X_X_X_X^^X_^X	m
quae regna scindit funditus, fratres necat;	qv[ae] re_gna^ sci_ndi&t fu_ndi^tu&s, fra_tre&s ne^ca&t; 	X_X_X_X_X_^X	v
quando et ita pestilens venenum livor est,	qva&ndo& e^t i^ta& pe_sti&le_ns ve&ne_nu&m li_vo^r e&st 	X^^X_X_X_X_^X	1.0
ut vitia tantum caetera excedat lue,	u&t vi^ti^a^ ta_ntu&m c[ae]te^ra& e_xce&da&t lu^e&  	X^^X_X_X_X_^X	v
virtute quantum Prosper excellit viros.	vi&rtu_te^ qva_ntu&m pro_spe^r e_xce&lli&t vi^ro&s 	X_X_X_X_X_^X	v
Per et profundum et fulgidum et castum polum	pe&r e&t pro^fu_ndu&m e&t fu_lgi^du&m e&t ca&stu&m po^lu&m 	X_X_X_X_X_^X	v
molleque solum aetheris et per alitum vias	mo&lle^qve^ so&lu&m [ae]the^ri^s e&t pe&r a_li&tu_m vi^a&s 	X^^X_^^_X_X_^X	1.0
delapsa terris, huc, ad hos veteris meos	de&la_psa^ te_rri&s hu_c a^d ho&s ve^te^ri&s me^o&s 	X_X_X_X_^^_^X	v
lauti hospites regni, dea et tetra et mari	la&vti& ho_spi&te&s re&gni_ de&a& e&t te&tra& e&t ma^ri& 	X_X_X_X_X_^X	1.0
iactata confugio: ita me infensa et procax	ja&cta_ta& co_nfu&gi^o& i^ta& me& i_nfe&nsa& e&t pro^ca&x 	X_X_X^^X_X_^X	1.0
partu sata meo, Invidia, prosequitur dolis,	pa&rtu_ sa^ta^ me^o& i&nvi^di^a^ pro_se^qvi^tu&r do^li&s 	X_X^^X^^X_^^_^X	v
monstrum vel inferis et invisum et grave.	mo&nstru&m ve&l i_nfe&ri_s e&t i_nvi&su&m e&t gra^ve& 	X_X_X_X_X_^X	1.0
O me parentem miseram, iterum et iterum mise—	o& me_ pa^re_nte&m mi^se^ra&m i^te^ru&m e^t i^te^ru&m mi^se& 	X_^_X^^^^^^^_^X	m
ram! Tot latebris totque in orbis arcibus,	ra&m to&t la&te_bri&s to_tqve& i&n o_rbi&s a_rci^bu&s 	X_X_X_X_X_^X	0.38
ad me tuendam nullus est datus locus:	a&d me_ tu&e_nda&m nu_llu&s e&st da&tu&s lo^cu&s 	X_X_X_X_X_^X	1.0
quocumque tendo, nata perturbat viam.	qvo&cu_mqve& te_ndo& na_ta& pe_rtu&rba&t vi^a&m 	X_X_X_X_X_^X	1.0
Tibi quidem, fastu hoc tuo posito, tuis,	ti&bi& qvi&de&m fa&stu& ho&c tu&o_ po^si^to_ tu^i&s 	X_X_X_X_^^_^X	1.0
o Ambitio, si temporibus obtemperes,	o& a&mbi_ti^o_ si& te_mpo^ri^bu^s o&bte_mpe^re&s 	X_X_X_X^^X_^X	m
quoad poteris, ipsa consules. Stat enim mihi	quoa&d po^te^ri^s, i_psa& co_nsu^le&s. sta^t e^ni&m mi^hi& 	X^^X_X_X_^^_^X	m
vetus sacellum, quo deum pater atque rex	ve&tu&s sa&ce_llu&m qvo_ de&u&m pa^te^r a_tqve^ re&x 	X_X_X_X_^^_^X	0.99
monstra atque curas progredi vetuit graves.	mo&nstra& a_tqve^ cu_ra&s pro_gre^di_ ve^tu^i&t gra^ve&s 	X_X_X_X_^^_^X	m
Erumna ab ipsis infimis mortalibus	e&ru_mna& a&b i_psi&s i_nfi&mi&s mo&rta_li^bu&s 	X_X_X_X_X_^X	1.0
malo vel ex parte minima levarier,	ma&lo_ ve&l e&x pa&rte^ mi^ni&ma_ le&va_ri^e&r 	X_X_X^^X_X_^X	1.0
quam omni a deorum grege gravi malo eripi.	qva&m o&mni& a_ de&o_ru&m gre^ge^ gra&vi_ ma&lo& e_ri^pi& 	X_X_X^^X_X_^X	1.0
Nam ab his quidem levi relato munere	na&m a&b hi&s qvi&de&m le&vi_ re&la_to& mu_ne^re& 	X_X_X_X_X_^X	1.0
pro maximo beneficii merito eximar.	pro& ma_xi^mo_ be&ne^fi^ci^i_ me^ri^to& e_xi^ma&r 	X_X_X^^X_^^_^X	m
At quis deorum est qui uspiam sibi esse par	a&t qvi&s de&o_ru&m e&st qvi& u_spi&a_m si&bi& e_sse^ pa&r 	X_X_X_X_X_^X	1.0
putet relatum, ubi me suis meritis deam	pu&te&t re&la_tu&m u^bi^ me& su&i&s me^ri^ti&s de^a&m 	X_X_^^_X_^^_^X	1.0
devinxerit? Nempe insolens divum est genus,	de_vi_nxe^ri&t ne&mpe& i_nso^le&ns di&vu&m e&st ge^nu&s 	X_X_X_X_X_^X	v
quod in dies parvo moveri munere	qvo&d i&n di&e&s pa&rvo_ mo&ve_ri& mu_ne^re& 	X_X_X_X_X_^X	1.0
dediscimus superi. At quid altas aedium	de&di_sci^mu&s su^pe^ri& a&t qvi^d a_lta&s [ae]di^u&m 	X_X_^^_X_X_^X	v
sedes inurentem intus Invidiam audio?	se&de_s i&nu_re&nte&m i_ntu&s i_nvi^di^a&m [au]di^o& 	X_X_X_X_^^_^X	1.0
Inde adeo iam, quoad fors feret, mihi consulam.	i_nde& a^de^o^ ia&m, quoa&d fo&rs fe^re&t, mi^hi^ co_nsu^la&m. 	X^^X_X_X_^^_^X	m
Cedam furenti: namque cedendo furor	ce&da&m fu&re_nti& na_mqve& ce_de&ndo_ fu^ro&r 	X_X_X_X_X_^X	1.0
frangitur. Abibo hinc ad Lares intro abditos.	fra&ngi^tu^r a&bi_bo& hi&nc a&d la&re_s i&ntro& a_bdi^to&s 	X^^X_X_X_X_^X	1.0
Ast ego? Meam quo me urbis artifices pii	a&st e^go^ me^a&m qvo& me& u_rbi^s a_rti^fi^ce&s pi^i& 	X^^X_X_X_^^_^X	v
locaverant sudore sordidam petam	lo&ca_ve^ra&nt su&do_re^ so_rdi&da&m pe^ta&m 	X_X_X_X_X_^X	v
aram, ut protervam hanc et domum et gentem suum	a&ra&m u&t pro&te_rva&m ha&nc e&t do&mu&m e&t ge&nte&m su^u&m 	X_X_X_X_X_^X	1.0
ruentem in excidium subinde rideam,	ru&e_nte&m i^n e_xci^di^u&m su^bi_nde& ri_de^a&m 	X_X_^^_X_X_^X	v
quando hic quidem nostri apud eosdem numinis	qva&ndo& hi&c qvi&de&m no&stri& a^pu^d e&o_sde&m nu_mi^ni&s 	X_X_X^^X_X_^X	1.0
ita nunc colendi ratio curave excidit.	i^ta^ nu&nc co^le_ndi& ra^ti^o^ cu_ra&ve& e_xci^di&t	^^_X_X^^X_X_^X	v
Etenim, sator deorum et hominum, Iuppiter,	e^te^ni&m sa&to&r de&o_ru&m e&t ho^mi^nu&m ju_ppi^te&r 	^^_X_X_X^^X_^X	1.0
qui aethera potes mari atque terras aetheri	qvi [ae]the^ra^ po^te&s ma&ri& a_tqve^ te_rra&s [ae]the^ri&	X^^X_X_X_X_^X	v
miscere nutu, numquid haud satis est tibi,	mi&sce_re& nu_tu& nu_mqvi&d h[au]d sa^ti^s e&st ti^bi& 	X_X_X_X_^^_^X	0.98
iras trisulca si exeris tuas face,	i&ra&s tri&su_lca& si& e_xe&ri&s tu&a&s fa^ce& 	X_X_X_X_X_^X	1.0
flammas et hinc et inde iaculans dextera	fla&mma_s e&t hi&nc e&t i_nde& ja^cu^la&ns de_xte^ra& 	X_X_X_X^^X_^X	1.0
ni vel feram hanc hominumque perniciem ultimam	ni& ve&l fe&ra&m ha&nc ho^mi^nu_mqve& pe_rni^ci^e&m u_lti^ma&m 	X_X_^^_X_^^_^X	1.0
terris feras? O et tu, olympicum decus,	te_rri&s fe^ra_s? o_ e&t tu&, o^ly_mpi^cu&m de^cu&s, 	X_X_X_X_X_^X	m
qui pulcher alta templa gemmis fulgidis	qvi& pu_lche&r a_lta& te_mpla& ge_mmi&s fu_lgi^di&s 	X_X_X_X_X_^X	1.0
expicta lustras, fervidis praeceps rotis,	e&xpi_cta^ lu_stra&s fe_rvi^di&s pr[ae]ce&ps ro^ti&s 	X_X_X_X_X_^X	v
vincisque dum libet atque prosternis feras,	vi&nci_sqve^ du&m li^be^t a_tqve^ pro_ste&rni&s fe^ra&s 	X_X_^^_X_X_^X	v
crinite Phoebe, usque adeo ne hos miseros potes	cri&ni_te^ ph[oe]be& u&sqve& a^de^o^ ne& ho&s mi^se^ro&s po^te&s 	X_X_X^^X_^^_^X	v
odisse mortalis, ut et quos Lucifer	o&di_sse^ mo_rta_li_s, u^t e&t quo&s lu_ci^fe&r 	X_X_X_X_X_^X	m
praemissus abs te quemque nuncians diem	pr[ae]mi_ssu&s a&bs te& qve_mqve& nu_nci&a_ns di^e&m 	X_X_X_X_X_^X	1.0
dulci a sopore matutinus excitet,	du_lci& a_ so^po_re& ma_tu_ti_nu&s e_xci^te&t, 	X_X_X_X_X_^X	v
et quos tu agas exerceasque laboribus	e&t qvo&s tu& a^ga_s e&xe_rce^a_sqve^ la^bo_ri^bu&s	X_X_X_X_^^_^X	v
sine fine duris atque Inorti concites,	si^ne^ fi_ne& du_ri&s a_tqve& i&no_rti& co_nci^te&s 	^^_X_X_X_X_^X	0.9
eos item a feralibus foede undique	e&o_s i&te&m a_ fe&ra_li&bu&s f[oe]de& u_ndi^qve& 	X_X_X_X_X_^X	1.0
monstris sub oculo gaudeas tuo premi?	mo&nstri&s su^b o^cu^lo& g[au]de^a&s tu&o& pre^mi&	X_X^^X_X_X_^X	v
Profecto sub te, Phoebe, respirat nihil	pro&fe_cto& su&b te& ph[oe]be& re_spi&ra&t ni^hi&l 	X_X_X_X_X_^X	1.0
durius homine; vel quos homo tandem sibi	du_ri^u^s ho&mi^ne^ ve&l qvo&s ho&mo_ ta_nde&m si^bi&	X^^X^^X_X_X_^X	m
faciles habebit, usque tam exosus diis?	fa^ci^le&s ha^be_bi&t u_sqve^ ta&m e_xo&su&s di^i&s	^^_X_X_X_X_^X	v
Immo et quidem sub sole delitiae deum	i&mmo& e&t qvi^de&m su&b so_le^ de_li^ti^[ae] de^u&m 	X_X_X_X_^^_^X	m
est homo, modo se hominem velit, non belluam.	e&st ho^mo^ mo&do^ se& ho^mi&ne&m ve&li&t no&n be_llu^a&m 	X^^X^^X_X_X_^X	m
Quodcunque vescitur aura et incolit globum,	qvo&dcu_nqve^ ve_sci^tu^r [au]ra& e^t i_nco&li&t glo^bu&m	X_X_^^_X_X_^X	v
quem premimus ipsi, plus diis cordi est quam homo.	qve&m pre^mi^mu^s i_psi& plu&s di^i&s co&rdi& e&st qva&m ho^mo&	X^^X_X_X_X_^X	v
Siquidem fames, langor, dolor, quae caeteris	si^qvi^de&m fa&me&s la&ngo_r do&lo&r qv[ae] c[ae]te^ri&s 	^^_X_X_X_X_^X	1.0
extrema sunt mala, nos apud capita ultimis	e&xtre_ma& su&nt ma^la^ no_s a&pu&d ca^pi^ta& u_lti^mi&s 	X_X_^^_X_^^_^X	0.94
angustiis obmersa non mala prima sunt,	a&ngu_sti&i_s o&bme_rsa& no&n ma^la^ pri_ma^ su&nt 	X_X_X_X_^^_^X	m
adeo angimur solliciti et innumeris malis.	a^de^o& a_ngi&mu&r so&lli^ci^ti& e&t i_nnu^me^ri&s ma^li&s	^^_X_X^^X_^^_^X	m
En stant comae mihi atque ab imis spiritus	e&n sta&nt co&m[ae] mi&hi& a_tqve& a&b i_mi&s spi_ri^tu&s 	X_X_X_X_X_^X	1.0
praecordiis gelat. Heu cado, heu desum mihi	pr[ae]co_rdi&i_s ge^la^t h[eu] ca&do& h[eu] de&su&m mi^hi& 	X_X_^^_X_X_^X	1.0
perculsus horrore, omnibus nervis fluens!	pe&rcu_lsu&s ho_rro&re& o_mni&bu&s ne&rvi&s flu^e&ns 	X_X_X_X_X_^X	1.0
O dulce, letum refugium, a diis datum	o& du_lce^ le_tu&m re^fu^gi^u&m a_ di&i&s da^tu&m 	X_X_X^^X_X_^X	m
nostris malis! Per te quidem erumnas graves,	no&stri&s ma&li&s pe&r te& qvi&de&m e_ru&mna_s gra^ve&s 	X_X_X_X_X_^X	1.0
maerorem, inopiam ponimus; per te fera	m[ae]ro_re&m i&no^pi^a&m po_ni&mu&s pe&r te_ fe^ra& 	X_X^^X_X_X_^X	m
monstra et refertam maximis vitam malis	mo&nstra& e&t re&fe_rta&m ma_xi&mi&s vi&ta&m ma^li&s 	X_X_X_X_X_^X	0.92
fugimus beasque quo minus sero obvenis.	fu^gi^mu&s be&a_sqve& qvo_ mi&nu&s se&ro& o_bve^ni&s 	^^_X_X_X_X_^X	0.5
Sapiens statuet hoc munus in vita sibi	sa^pi^e&ns sta&tu^e^t ho&c mu_nu&s i&n vi&ta_ si^bi& 	^^_X^^X_X_X_^X	m
se se ut ferat, cum nullus adversus magis	se& se& u&t fe&ra&t cu&m nu_llu&s a_dve&rsu&s ma^gi&s 	X_X_X_X_X_^X	1.0
homini aut molestus est magis, quam homo met sibi.	ho^mi^ni& [au]t mo&le_stu&s e&st ma&gi&s qva&m ho^mo^ me_t si^bi& 	^^_X_X_X_^^_^X	1.0
Tum qui suas apte volet res ducere,	tu&m qvi& su&a_s a&pte_ vo&le&t re&s du_ce^re& 	X_X_X_X_X_^X	1.0
is muniet mentem artibus bonis suam:	i&s mu_ni&e&t me&nte&m a_rti&bu&s bo&ni&s su^a&m 	X_X_X_X_X_^X	1.0
qua fretus haud ullas cohorrebit feras.	qva& fre_tu&s h[au]d u&lla&s co&ho_rre&bi_t fe^ra&s 	X_X_X_X_X_^X	1.0
Virtuti opem superi ferunt: nocet nihil.	vi&rtu_ti& o&pe&m su^pe^ri_ fe&ru&nt no&ce&t ni^hi&l 	X_X_^^_X_X_^X	1.0
Immo dii summi, infimi ac medioxumi,	i&mmo_ di&i_ su&mmi& i_nfi&mi& a&c me^di^o_xu^mi& 	X_X_X_X_^^_^X	1.0
virtutem odio habent, quando livorem impium	vi&rtu_te&m o&di^o& ha^be&nt qva_ndo& li_vo&re&m i_mpi^u&m 	X_X^^X_X_X_^X	1.0
monstrumque virtuti insidens non amovent.	mo&nstru_mqve& vi_rtu&ti& i_nsi&de_ns no&n a_mo^ve&nt 	X_X_X_X_X_^X	1.0
Vos ne, dii, hanc tam pestilentem bestiam	vo&s ne_ di&i& ha&nc ta&m pe_sti&le_nte&m be_sti^a&m 	X_X_X_X_X_^X	1.0
publicaque privataque volutantem loca	pu&bli^ca^qve^ pri_va&ta^qve^ vo^lu_ta&nte&m lo^ca&	X^^X_X^^X_X_^X	m
sinitis nec arcetis, dii, ne lurido	si^ni^ti&s ne&c a_rce&ti_s di&i_ ne& lu_ri^do& 	^^_X_X_X_X_^X	1.0
sacra et prophana omnia pedore polluat?	sa&cra& e&t pro&pha_na& o&mni^a^ pe&do_re& po_llu^a&t 	X_X_X^^X_X_^X	m
Exanimor hoc equidem! Sed, o superi, probe	e&xa^ni^mo&r ho_c e^qvi^de&m se&d o_ su^pe^ri& pro^be& 	X^^X_^^_X_^^_^X	1.0
vestrae hinc saluti est additum: Invidiam simul	ve&str[ae] hi&nc sa&lu_ti& e&st a_ddi&tu&m i_nvi^di^a&m si^mu&l 	X_X_X_X_^^_^X	1.0
iecistis orbis monstruosi ad incolas	je&ci_sti&s o_rbi&s mo_nstru&o_si& a&d i_nco^la&s 	X_X_X_X_X_^X	1.0
eique thalares fero monstro leves	e&i_que^ tha_la&re&s fe^ro_ mo_nstro_ le^ve&s 	X_X_X_X_X_^X	m
vetuistis alarumque ventivolas iubas.	ve&t[ui]sti&s a_la&ru_mqve& ve_nti^vo^la_s ju^ba&s 	X_X_X_X_^^_^X	1.0
Quod si supernum volitet attingens polum,	qvo&d si_ su&pe_rnu&m vo^li^te&t a_tti&nge_ns po^lu&m 	X_X_X^^X_X_^X	1.0
non dubito quin audax comam Baccho secet,	no&n du^bi^to& qvi_n [au]da&x co&ma&m ba&ccho_ se^ce&t 	X^^X_X_X_X_^X	1.0
discerpat ex humeris Dianae arcum aureum	di&sce_rpa&t e&x hu^me^ri&s di&a_n[ae] a&rcu&m [au]re^u&m 	X_X_^^_X_X_^X	0.98
pharetramque distrudatque clangifragam tubam	pha^re^tra_mqve& di_stru&da_tqve& cla_ngi^fra^ga_m tu^ba&m 	^^_X_X_X_^^_^X	0.43
ensemque cornipedemque Mavorti fero,	e&nse_mqve& co_rni^pe^de_mqve& ma_vo&rti_ fe^ro& 	X_X_^^_X_X_^X	1.0
Phoebe lyram altiboanteque a maris deo	ph[oe]be^ ly^ra&m a&lti_bo&a_nte&qve& a_ ma&ri&s de^o&	X^^X_X_X_X_^X	m
tridentem et ex tua, o Tonans, fulmen manu	tri&de_nte&m e&t e&x tu&a& o_ to&na&ns fu&lme&n ma^nu& 	X_X_X_X_X_^X	1.0
vertat, novum, horrendum atque inauditum nefas,	ve&rta&t no&vu&m ho_rre&ndu&m a_tqve& i&n[au]di&tu_m ne^fa&s 	X_X_X_X_X_^X	1.0
caelumque caelicolasque non secus ac domum,	c[ae]lu_mqve& c[ae]li^co^la_sqve& no&n se^cu^s a&c do^mu&m 	X_X_^^_X_^^_^X	1.0
Lares, Penates Masinisse dissipet.	la&re&s, pe^na_te&s ma_si_ni_sse& di_ssi^pe&t. 	X_X_X_X_X_^X	v
Ita, quam timent luem et relegant dii procul,	i^ta^ qva&m ti&me&nt lu&e&m e^t re^le&ga&nt di&i& pro^cu&l 	^^_X_X^^X_X_^X	m
virtute fretus quispiam, qui homo sit, feret?	vi&rtu_te& fre_tu&s qvi_spi&a_m qvi& ho^mo^ si&t fe^re&t 	X_X_X_X_^^_^X	1.0
Nunquam, dum erunt homines, erit non foeta humus	nu&nqva&m du&m e&ru&nt ho^mi^ne_s e&ri&t no&n f[oe]ta& hu^mu&s 	X_X_^^_X_X_^X	1.0
monstris nefandis: nam ultro monstra hi provocant	mo&nstri&s ne&fa_ndi&s na&m u_ltro& mo_nstra& hi& pro_vo^ca&nt 	X_X_X_X_X_^X	1.0
passimque blandiuntur et coalunt sinu.	pa&ssi_mqve& bla_ndi&u_ntu&r e&t co^a^lu_nt si^nu& 	X_X_X_X_^^_^X	1.0
Ergo libet hinc effugere ab omni hominum grege.	e&rgo_ li^be^t hi&nc e&ffu^ge^re& a&b o_mni& ho^mi^nu&m gre^ge& 	X_^^_X^^X_^^_^X	m
Velim furentis aethere obvolvi Nothos	ve&li&m fu&re_nti&s [ae]the&re& o_bvo&lvi_ no^tho&s 	X_X_X_X_X_^X	1.0
vastisque convalles hiatibus hiscere	va&sti_sqve& co_nva&lle_s hi&a_ti^bu^s hi_sce^re& 	X_X_X_X_^^_^X	1.0
fragoreque ingenti superba rupium	fra&go_re&qve& i_nge&nti_ su&pe_rba& ru_pi^u&m 	X_X_X_X_X_^X	1.0
circumruere culmina et ab imis sedibus	ci&rcu_mru&e^re^ cu&lmi^na& e^t a&b i_mi&s se_di^bu&s	X_X^^X^^X_X_^X	m
alte procellis concuti totum mare	a&lte& pro&ce_lli&s co_ncu&ti_ to&tu&m ma^re& 	X_X_X_X_X_^X	1.0
in ultimam pestem luemque gentium,	i&n u_lti&ma&m pe&ste&m lu&e_mqve& ge_nti^u&m 	X_X_X_X_X_^X	1.0
quandoquidem in hominum genere tam male liberos	qva&ndo^qvi^de&m i^n ho^mi^nu&m ge^ne^re^ ta&m ma^le^ li_be^ro&s	X^^X^^X^^X_^^_^X	m
iam tum parentes impii oderunt suos.	ja&m tu&m pa&re_nte&s i_mpi&i& o_de&ru&nt su^o&s 	X_X_X_X_X_^X	1.0
Quis adeo fortis est, quis est tam ferreus	qui^s a^de^o^ fo_rti&s e&st, qui^s e&st ta&m fe_rre^u&s 	X^^X_X_X_X_^X	v
qui non ut ego scelus in Micissa fulminet?	qvi& no_n u^t e^go& sce^lu^s i&n mi&ci_ssa& fu_lmi^ne&t 	X_^^_^^_X_X_^X	1.0
En mihi furore pectus accensum labat.	e&n mi^hi^ fu&ro_re& pe_ctu&s a_cce&nsu&m la^ba&t 	X^^X_X_X_X_^X	0.81
Quisque facinus suum male admissum ferat	qvi&sqve^ fa^ci&nu&s su&u&m ma&le& a_dmi&ssu&m fe^ra&t 	X^^X_X_X_X_^X	1.0
aegre et moleste, nil per alienum vigil.	[ae]gre& e&t mo&le_ste& ni&l pe&r a^li^e&nu&m vi^gi&l 	X_X_X_X^^X_^X	1.0
Externa ab iniuria oritur vehemens dolor.	e&xte_rna& a&b i_nju&ri^a& o^ri&tu&r ve^he^me_ns do^lo&r 	X_X_X^^X_^^_^X	1.0
Tuum esse iam incipiet malum quo non bene	tu&u&m e_sse& ja&m i_nci^pi^e&t ma&lu&m qvo& no&n be^ne& 	X_X_^^_X_X_^X	1.0
tecum sit, et quicunque, secum dissidens,	te&cu&m si&t e&t qvi&cu_nqve& se_cu&m di_ssi^de&ns 	X_X_X_X_X_^X	1.0
animo suo illuctatur, haud quaquam ocium	a^ni^mo& su&o& i_llu&cta_tu&r h[au]d qva&qva&m o_ci^u&m 	^^_X_X_X_X_^X	1.0
prestabit aliis. Esse te regem scias.	pre&sta_bi&t a^li^i&s e_sse& te_ re&ge&m sci^a&s 	X_X^^X_X_X_^X	1.0
Servum scio atque ipsum quidem regnum est miser-	se&rvu&m sci&o& a_tqve& i&psu&m qvi&de&m re&gnu&m e&st mi^se&r 	X_X_X_X_X_^X	1.0
rum. Illi et mali hoc inest, ut omnia cum queas	ru&m i&lli& e&t ma&li& ho_c i&ne&st u&t o_mni^a^ cu&m qve^a&s 	X_X_X_X_^^_^X	1.0
tum et tibi nihil satis queas aeque ut velis.	tu&m e&t ti^bi^ ni&hi&l sa&ti&s qve&a_s [ae]qve& u&t ve^li&s 	X^^X_X_X_X_^X	0.38
Iuvat in hominum vita minus velle ac minus	iu^va^t i^n ho^mi^nu&m vi&ta_ mi&nu&s ve&lle& a&c mi^nu&s	^^^^^_X_^_X_^X	m
eniti in omni re usque quam possis tibi:	e&ni_ti& i&n o_mni& re& u_sqve& qva&m po&ssi&s ti^bi& 	X_X_X_X_X_^X	1.0
quo fit ut et inde plura possis quam velis.	qvo& fi^t u^t e&t i_nde& plu_ra& po_ssi&s qva&m ve^li&s 	X^^X_X_X_X_^X	0.45
At regium est grandia minus nolle ac queas.	a&t re_gi&u&m e&st gra&ndi^a^ mi&nu&s no&lle& a&c qve^a&s 	X_X_X^^X_X_^X	1.0
O impium dirumque productum ex ea	o_ i_mpi^u&m di_ru_mque^ pro_du_ctu&m e&x e^a& 	X_X_X_X_X_^X	m
dura impiaque stirpe Getula! O ferum,	du_ra& i_mpi^a_que& sti_rpe^ ge_tu_la&! o_ fe^ru&m, 	X_X_X_X_X_^X	v
cui filii tam sint odio ut hunc sordidum	cu&j fi_li&i_ ta&m si&nt o&di^o& u^t hu&nc so_rdi^du&m 	X_X_X_X^^X_^X	1.0
adiecerit regni coheredem sui!	a&dje_ce&ri&t re&gni_ co&he_re&de_m su^i& 	X_X_X_X_X_^X	1.0
Eum ne Iugurtham patre incerto editum	e&u&m ne& ju_gu&rtha_m pa&tre& i_nce&rto& e_di^tu&m 	X_X_X_X_X_^X	1.0
dolisque regiam male acturum suis?	do&li_sqve& re_gi&a_m ma&le& a_ctu&ru_m su^i&s 	X_X_X_X_X_^X	1.0
Et quem ille tu ne, tu ne regem, tu parem	e&t qve&m i_lle& tu_ ne& tu_ ne& re_ge&m tu_ pa^re&m 	X_X_X_X_X_^X	1.0
regnique filiisque consortem tuis?	re&gni_qve& fi_li&i_sqve& co_nso&rte&m tu^i&s 	X_X_X_X_X_^X	1.0
Sceleste! Nemo solus imperium gerit.	sce&le_ste& ne_mo& so_lu&s i_mpe^ri^u&m ge^ri&t 	X_X_X_X_^^_^X	1.0
Quisquis alieno arbitrio aget rem, serviet.	qvi&sqvi^s a^li&e_no& a&rbi^tri^o& a&ge&t re&m se_rvi^e&t 	X^^X_X^^X_X_^X	1.0
Profecto consiliis bonis nisi ultro rex	pro_fe_cto_ co_nsi^li^i&s bo^ni&s ni&si& u_ltro^ re&x 	X_X_^^_X_X_^X	m
paruerit, aegre abinde parebit malis.	pa&ru^e^ri&t [ae]gre& a&bi_nde& pa_re&bi&t ma^li&s 	X^^X_X_X_X_^X	0.92
Quisquis malos timet, profecto omnes timet.	qvi&sqvi&s ma&lo&s ti&me&t pro&fe_cto& o&mne&s ti^me&t 	X_X_X_X_X_^X	1.0
Homines vel oderunt vel optant quod neque—	ho^mi^ne&s ve^l o_de&ru&nt ve^l o_pta&nt quo&d ne^que&	^^_X_X_X_X_^X	m
unt; male qui et oderit, studet semper male.	u&nt ma^le^ qvi& e&t o_de&ri&t stu&de&t se&mpe&r ma^le& 	X^^X_X_X_X_^X	1.0
Regique regem qui dabit, regnum abstrahet.	re&gi_qve& re_ge&m qvi_ da&bi&t re&gnu&m a_bstra^he&t 	X_X_X_X_X_^X	1.0
Frater ne fratrem non colet? Colet? Ubi nam	fra&te&r ne& fra_tre&m no&n co&le&t co&le^t u^bi^ na&m 	X_X_X_X_X^^^X	1.0
tutus erit amor, odisse cum possis homo	tu&tu^s e^ri&t a^mo^r o&di_sse& cu&m po&ssi&s ho^mo&	X^^X^^X_X_X_^X	m
et nostra mens a rebus omnis pendeat?	e&t no_stra& me&ns a& re_bu&s o_mni&s pe_nde^a&t 	X_X_X_X_X_^X	1.0
Amabere ut voles. Volam ut tempus feret.	a&ma_be&re& u&t vo&le&s vo&la&m u&t te&mpu&s fe^re&t 	X_X_X_X_X_^X	1.0
Modo ne hoc agas invitus et regum omnium	mo^do^ ne& ho_c a&ga_s i&nvi_tu&s e&t re&gu&m o_mni^u&m	^^_X_X_X_X_^X	m
eris ipse foelicissimus. Id optent licet.	e^ri^s i_pse& f[oe]li&ci_ssi&mu^s i^d o&pte&nt li^ce&t 	^^_X_X_X^^X_^X	1.0
Quo nam hinc agitur aut abit Hyempsal? Quid furit?	qvo& na&m hi&nc a&gi^tu^r [au]t a^bi^t hy&e_mpsa&l qvi&d fu^ri&t	X_X^^X^^X_X_^X	m
Quo eum volentem fata praecipitant sua.	qvo& e&u&m vo&le_nte&m fa_ta& pr[ae]ci^pi^ta&nt su^a& 	X_X_X_X_^^_^X	1.0
Fatum est id homini nosse fatis cedere?	fa&tu&m e&st i&d ho^mi^ni& no_sse& fa_ti&s ce_de^re& 	X_X^^X_X_X_^X	1.0
Fatum ferendo vincitur. Quicquid feras,	fa&tu&m fe&re_ndo& vi_nci&tu&r qvi&cqvi&d fe^ra&s 	X_X_X_X_X_^X	1.0
premit atque fatum posse ferre fortiter	pre^mi^t a_tqve& fa_tu&m po_sse& fe_rre& fo_rti^te&r 	^^_X_X_X_X_^X	1.0
fatum est. Enim hominum nemo foelix unquam erit	fa&tu&m e&st e&ni&m ho^mi^nu&m ne_mo& f[oe]li&x u_nqva&m e^ri&t 	X_X^^X_X_X_^X	1.0
invitus. At Livor quod aspectu foret	i&nvi_tu&s a&t li&vo&r qvo&d a_spe&ctu_ fo^re&t 	X_X_X_X_X_^X	1.0
truculentus ac foedus, quod horrendus nimis,	tru^cu^le_ntu&s a&c f[oe]du&s qvo&d ho_rre&ndu&s ni^mi&s 	^^_X_X_X_X_^X	1.0
a matre primum medio in oceani scoplo	a& ma_tre& pri_mu&m me^di^o& i&n o_ce^a^ni& sco^plo& 	X_X_X^^X_^^_^X	1.0
expositus aspero et minaci rupibus,	e&xpo^si^tu&s a_spe&ro& e&t mi&na_ci& ru_pi^bu&s 	X^^X_X_X_X_^X	1.0
circumstrepentis aquae fragore fervido	ci&rcu_mstre&pe_nti^s a^qv[ae] fra&go_re& fe_rvi^do& 	X_X_^^_X_X_^X	1.0
alitur; abinde cadavere advectus petit	a&li^tu^r a^bi_nde^ ca^da_ve^re& a_dve&ctu&s pe^ti&t	X^^X_^^_X_X_^X	m
terras et extemplo mali accepti memor	te&rra_s e&t e_xte&mplo_ ma&li& a_cce&pti_ me^mo&r 	X_X_X_X_X_^X	1.0
totum per orbem persequitur odiis deam.	to&tu&m pe&r o_rbe&m pe_rse^qvi^tu^r o^di^i&s de^a&m	X_^_X_^^^^^_^X	m
Exterrita illa metu, abdidit sese procul	e&xte_rri&ta& i_lla^ me^tu& a_bdi&di&t se&se& pro^cu&l 	X_X_^^_X_X_^X	1.0
spelunca opaca intra nemus Ericthonium.	spe&lu_nca& o^pa_ca& i_ntra_ ne^mu^s e^ri_ctho_ni^u&m. 	X_X_X_X^^X_^X	m
Subinde nostram regiam Ambitio haec parens	su&bi_nde& no_stra&m re_gi&a&m a_mbi^ti^o h[ae]c pa^re&ns	X_X_X_X_^^_^X	m
ut subiit, heu, Livor inimicus appulit	u&t su^bi^i&t h[eu] li&vo^r i^ni&mi_cu&s a_ppu^li&t 	X^^X_X^^X_X_^X	1.0
turbatque prosternitque cuncta funditus.	tu&rba_tqve& pro_ste&rni_tqve& cu_ncta& fu_ndi^tu&s 	X_X_X_X_X_^X	1.0
Non tanta, quantam qui intulerit, iniuria est,	no&n ta_nta& qva_nta&m qvi& i_ntu&le^ri^t i&nju_ri^a& e&st	X_X_X_X^^X_^X	m
sed tanta, quantam quis sibi illatam estimat.	se&d ta_nta& qva_nta&m qvi&s si&bi& i_lla&ta&m e_sti^ma&t 	X_X_X_X_X_^X	1.0
Modicum est nihil, quod a dolore est maximo.	mo^di^cu&m e&st ni&hi&l qvo&d a_ do&lo_re& e&st ma_xi^mo& 	^^_X_X_X_X_^X	1.0
Dolebis in dies minus, cum plus sapis.	do^le_bi^s i&n di^e&s mi^nu&s, cu&m plu&s sa^pi^s. 	X_X_X_X_X_^X	m
Homini sat est nosse agere rem ex sententia.	ho^mi^ni_ sa&t e&st no&sse& a^ge^re& re&m e&x se&nte_nti^a& 	^^_X_X^^X_X_^X	1.0
Quaeque institueris rite, facile est exequi.	qv[ae]qve& i_nsti&tu^e^ri&s ri_te& fa^ci^le& e&st e_xe^qvi& 	X_X^^X_X^^X_^X	m
Consilia probet eventus. Interim hac mea	co&nsi^li^a& pro^be^t e_ve_ntu&s i_nte&ri&m ha&c me^a& 	X^^X^^X_X_X_^X	m
fruor voluptate ac libidinem expleo:	fru&o&r vo&lu_pta&te& a&c li&bi_di&ne&m e_xple^o& 	X_X_X_X_X_^X	1.0
medio ne consessu quasi et parentem eum	me^di^o_ ne& co_nse&ssu& qva&si& e&t pa&re_nte&m e^u&m 	^^_X_X_X_X_^X	1.0
dignabimur nostro, ne sordidum in domum	di&gna_bi&mu_r no&stro_ ne& so_rdi&du&m i&n do^mu&m 	X_X_X_X_X_^X	1.0
nostram hunc calonem pene conventitium.	no_stra&m hu&nc ca_lo_ne&m pe_ne^ co_nve_nti_ti^u&m. 	X_X_X_X_X_^X	m
Operae precium abiisse sit eum tristius	o^pe^r[ae] pre^ci^u&m a^bi&i_sse^ si^t e^u&m tri_sti^u&s 	^^_X^^X_X^^X_^X	m
a sede quam, velut arrogans est, abfuit.	a& se_de& qva&m ve^lu^t a_rro&ga_ns e&st a_bfu^i&t 	X_X_^^_X_X_^X	0.98
Confingat ut vult modo Iugurtha atque ut solet.	co&nfi_nga&t u&t vu&lt mo^do^ ju&gu_rtha& a&tqve& u&t so^le&t 	X_X_X^^X_X_^X	0.95
Hoc ipse letor quando sub risu impio	ho&c i_pse& le_to&r qva_ndo& su&b ri&su& i_mpi^o& 	X_X_X_X_X_^X	1.0
undare sensi lachrymas moestas suo.	u&nda_re& se_nsi& la_chry&ma_s m[oe]sta_s su^o& 	X_X_X_X_X_^X	1.0
Sed cum molestus esse cuiquam ceperis,	se&d cu&m mo&le_stu&s e_sse& cu_jqva&m ce_pe^ri&s 	X_X_X_X_X_^X	1.0
opprimito, moles interim in te ne ruat.	o&ppri^mi^to& mo_le&s i_nte&ri&m i&n te& ne_ ru^a&t 	X^^X_X_X_X_^X	1.0
Immo et, molestus esse cuiquam ut coeperis	i&mmo& e&t mo&le_stu&s e_sse& cu_jqva&m u&t c[oe]pe^ri&s 	X_X_X_X_X_^X	1.0
desinito, ne tuum in caput molem struas.	de&si^ni^to& ne_ tu&u&m i&n ca&pu&t mo&le&m stru^a&s 	X^^X_X_X_X_^X	1.0
Qui e fronte risu tedium abstersit sua,	qvi& e& fro_nte& ri_su& te_di&u&m a_bste&rsi_t su^a& 	X_X_X_X_X_^X	1.0
cum consulit sibi, tum et infestis simul	cu&m co_nsu&li&t si&bi_ tu&m e&t i_nfe&sti&s si^mu&l 	X_X_X_X_X_^X	0.19
importat ut doleant; et usque principem	i&mpo_rta&t u&t do^le^a&nt e&t u_sqve& pri_nci^pe&m 	X_X_^^_X_X_^X	1.0
beneficiis clarum esse pulchre condecet.	be&ne^fi^ci^i&s cla&ru&m e_sse^ pu_lchre& co_nde^ce&t	X^^X_X_X_X_^X	m
Beneficio ne tu satis hominem tuo,	be&ne^fi^ci^o_ ne& tu_ sa^ti^s ho^mi&ne&m tu^o&	X^^X_X_X^^X_^X	m
qui prebet ingratum inde se, devincies?	qvi& pre_be&t i_ngra&tu&m i_nde& se_ de&vi_nci^e&s 	X_X_X_X_X_^X	1.0
En gratum hominem amarique dignum qui, inmemor	e&n gra_tu&m ho&mi^ne&m a^ma&ri_qve& di_gnu&m qvi& i_nme^mo&r 	X_X^^X_X_X_^X	1.0
doni a Micissa patre collati sibi,	do&ni& a_ mi&ci_ssa& pa_tre& co_lla&ti_ si^bi& 	X_X_X_X_X_^X	0.69
decreta, quibus est tractus in regnum, rogo	de&cre_ta& qvi^bu^s e&st tra_ctu&s i&n re&gnu&m ro^go& 	X_X^^X_X_X_^X	1.0
vix funerum extincto, esse per se turpiter	vi&x fu_ne&ru&m e_xti&ncto& e_sse& pe&r se& tu_rpi^te&r 	X_X_X_X_X_^X	1.0
rescissa studeat impudens, et impudens	re_sci_ssa^ stu^de^a^t i_mpu^de&ns, e&t i_mpu^de&ns 	X_X^^X_X_X_^X	v
qui exordium regni eruendi patriis	qvi& e_xo_rdi^u&m re&gni& e_ru^e_ndi_ pa_tri^i&s 	X_X_X_X_X_^X	m
sanctisque vertendis capiat a legibus:	sa&ncti_sqve& ve_rte&ndi&s ca&pi^a^t a& le_gi^bu&s	X_X_X_X^^X_^X	m
regni luem excidiumque nimirum parat.	re&gni_ lu&e&m e_xci^di^u_mqve& ni_mi&ru&m pa^ra&t 	X_X_^^_X_X_^X	1.0
Cavendum, Adherbal, tibi necem is ferox parat.	ca&ve_ndu&m a&dhe_rba&l ti^bi^ ne&ce&m i&s fe&ro&x pa^ra&t 	X_X_X^^X_X_^X	0.85
Fastum quidem obsequio propere vinces tuo.	fa&stu&m qui^de&m o_bse^qvi^o& pro^pe^re_ vi_nce&s tu^o&. 	X_X_^^_^^_X_^X	v
Quin fastus obsequio procacius intumet,	qvi&n fa_stu^s o_bse^qvi^o& pro^ca_ci^u^s i_ntu^me&t	X_X_^^_X_^^_^X	m
et insolentem qui haud cohercet, illicit.	e&t i_nso&le_nte&m qvi& h[au]d co&he_rce&t i_lli^ci&t 	X_X_X_X_X_^X	1.0
Sed familiae nostros Penates ac deos	se&d fa^mi^li^[ae] no_stro&s pe^na_te_s a&c de^o&s	X^^X_X_X_X_^X	m
probe in dies opem esse laturos scio.	pro&be& i&n di&e_s o&pe&m e_sse& la_tu&ro&s sci^o& 	X_X_X_X_X_^X	1.0
Spem esse meriti filiam vulgo ferunt,	spe&m e_sse^ me^ri^ti_ fi_li^a&m vu_lgo_ fe^ru&nt, 	X_X^^X_X_X_^X	m
sperasse et adeo bona bene merendo licet.	spe&ra_sse& e^t a^de^o& bo^na^ be^ne^ me^re_ndo_ li^ce&t. 	X_X^^X^^X^^X_^X	c
Apud inmerentem bene mereri dum voles	a^pu^d i_nme&re_nte&m be^ne^ me&re_ri& du&m vo^le&s 	^^_X_X^^X_X_^X	1.0
demerueris. Rem egisse pro officio sat est.	de&me^ru^e^ri&s re&m e&gi_sse^ pro& o_ffi^ci^o_ sa^t e&st	X^^X_X_X_^^_^X	m
Et quid soluto crine, nudo pectore	e&t qvi&d so&lu_to& cri_ne& nu_do& pe_cto^re& 	X_X_X_X_X_^X	1.0
scissaque Phitonissa veste cursitat?	sci&ssa_qve& phi_to&ni_ssa& ve_ste& cu_rsi^ta&t 	X_X_X_X_X_^X	1.0
Quid se furore concitat? Quid igneos	qvi&d se_ fu&ro_re& co_nci&ta&t qvi&d i_gne^o&s 	X_X_X_X_X_^X	1.0
obvolvit oculos atque murmurans tumet?	o&bvo_lvi&t o^cu^lo&s a_tqve& mu_rmu&ra_ns tu^me&t 	X_X^^X_X_X_^X	1.0
En ut repente, quasi obviis exterrita	e&n u^t re^pe&nte& qva&si& o_bvi&i_s e&xte_rri^ta& 	X^^X_X_X_X_^X	m
umbris grave infestis, propere haerens loco	u&mbri&s gra^ve& i_nfe_sti&s, pro^pe^re_ h[ae]re&ns lo^co&	X_X_X_^^_X_^X	m
vim ponit irarum atque conatus fremens.	vi&m po_ni&t i_ra&ru&m a_tqve& co_na&tu&s fre^me&ns 	X_X_X_X_X_^X	1.0
Euhoe! Ut inter clamitandum obmutuit	[eu]h[oe]! u^t i_nte&r cla_mi^ta_ndu&m o_bmu_tu^i&t 	X_X_X_X_X_^X	m
truculenta, ut introrsus renitens faucibus	tru^cu^le_nta& u&t i_ntro&rsu&s re&ni_te&ns f[au]ci^bu&s 	^^_X_X_X_X_^X	1.0
verba negat, ut se se premens totis simul	ve&rba^ ne^ga&t u&t se& se& pre&me&ns to&ti&s si^mu&l	X^^X_X_X_X_^X	m
exaestuans membrisque nervisque attremit,	e&x[ae]stu&a_ns me&mbri_sqve& ne_rvi&sqve& a_ttre^mi&t 	X_X_X_X_X_^X	1.0
ut torpet, ut modo pone subvertit solo	u&t to_rpe&t u&t mo^do^ po_ne& su_bve&rti&t so^lo& 	X_X_^^_X_X_^X	0.67
obliqua lumina, modo subrepta altius	o&bli_qva^ lu_mi&na^ mo^do^ su_bre&pta& a_lti^u&s	X_X_X^^X_X_^X	m
cervice torvos erigit vultus. Papae!	ce&rvi_ce& to_rvo&s e_ri&gi&t vu&ltu&s pa^p[ae] 	X_X_X_X_X_^X	1.0
Io Libes misere, Libes misere, libes	i&o_ li&be&s mi^se^re_ li&be&s mi^se^re_ li^be&s	X_X_^^_X_^^_^X	m
matresque nurusque misere, complete, io,	ma&tre_sque^ nu^ru_sque^ mi^se^re_, co_mple&te_, i^o&, 	X_^^_X^^X_X_^X	m
complete sylvas atque montes planctibus!	co&mple_te& sy_lva&s a_tqve& mo_nte&s pla_ncti^bu&s 	X_X_X_X_X_^X	1.0
Te, te quidem te cerno Tyrrnidam impiam:	te& te& qvi&de&m te& ce_rno& ty_rrni&da&m i_mpi^a&m 	X_X_X_X_X_^X	1.0
tu male latentem clave adultera necas,	tu& ma^le^ la&te_nte&m cl[au]e& a&du_lte&ra_ ne^ca&s 	X^^X_X_X_X_^X	1.0
et te tridentem, una resecta cuspide,	e&t te& tri&de_nte&m u&na_ re&se_cta& cu_spi^de& 	X_X_X_X_X_^X	1.0
male in duas findi hinc et inde dissides	ma&le& i&n du&a&s fi&ndi& hi&nc e&t i_nde& di_ssi^de&s 	X_X_X_X_X_^X	1.0
partis video. Tu Cirtha profugum, he he, tuo	pa_rti&s vi^de^o_. tu_ ci_rtha^ pro^fu^gu&m, he^ he^, tu^o& 	X_^^_X_X^^X^^^X	m
profugum, tuo haud gremio satis servas diu!	pro^fu^gu&m tu&o& h[au]d gre^mi^o_ sa&ti&s se&rva&s di^u& 	^^_X_^^_X_X_^X	1.0
Stat ales Evandri atque rostro et unguibus	sta&t a_le&s [eu]a&ndri& a_tqve& ro_stro& e&t u_ngvi^bu&s 	X_X_X_X_X_^X	1.0
libycos male exturbat gravi nidos lue.	li^by^co&s ma&le& e_xtu&rba&t gra&vi_ ni&do&s lu^e& 	^^_X_X_X_X_^X	1.0
Heu, Zama, purpureis madescis imbribus!	h[eu], za_ma^, pu_rpu^re^i&s ma^de_sci&s i_mbri^bu&s! 	X_X_^^_X_X_^X	m
Vaccea pubes, tertio haud rides die!	va&cce_a& pu_be&s te_rti&o& h[au]d ri&de&s di^e& 	X_X_X_X_X_^X	1.0
Igne tibi, Tala, facis tenebras ultimas!	i&gne^ ti^bi^ ta^la^ fa&ci&s te^ne_bra&s u_lti^ma&s 	X^^X^^X_X_X_^X	m
Capsa, aureos tum reddis ungues aliti	ca&psa& [au]re&o&s tu&m re_ddi&s u_ngve&s a_li^ti& 	X_X_X_X_X_^X	0.98
et tibi, Mulucha, non cocleis laetus tuis	e&t ti^bi^ mu&lu_cha& no&n co&cl[ei]s l[ae]tu&s tu^i&s 	X^^X_X_X_X_^X	0.85
noctem iubare fuscat alacrem Titan suo!	no&cte&m ju&ba^re^ fu&sca^t a^la&cre&m ti&ta&n su^o&	X_X^^X^^X_X_^X	m
Et tu ipse, quem surrepta servat litera,	e&t tu& i_pse& qve&m su&rre_pta& se_rva&t li_te^ra& 	X_X_X_X_X_^X	1.0
ne crede, ne crede veteri atavorum hospiti!	ne& cre_de^ ne& cre&de^ ve^te^ri& a^ta^vo&ru&m ho_spi^ti&	X_X_X^^X^^X_^X	m
Plura vetat hac in parte Phoebus proloqui,	plu&ra^ ve^ta&t ha_c i&n pa_rte& ph[oe]bu&s pro_lo^qvi&	X^^X_X_X_X_^X	m
sed fata summum denique exuperant Iovem.	se&d fa_ta& su_mmu&m de_ni&qve& e_xu^pe^ra_nt jo^ve&m 	X_X_X_X_^^_^X	1.0
O plena numine, cui futura Phytius	o& ple_na^ nu_mi^ne^ cu&j fu^tu_ra& phy_ti^u&s	X_X_^^_X_X_^X	v
ordine aperit, si precibus ullis flecteris,	o&rdi^ne& a^pe&ri&t si& pre^ci^bu&s u_lli&s fle_cte^ri&s 	X^^X_X^^X_X_^X	1.0
nostros aperte iam edoce casus, precor!	no&stro_s a&pe_rte& ja&m e_do&ce_ ca&su&s pre^co&r 	X_X_X_X_X_^X	1.0
Quo liceat evitasse per te aut fortiter	qvo& li^ce^a&t e_vi&ta_sse& pe&r te& [au]t fo_rti^te&r 	X^^X_X_X_X_^X	1.0
subiisse, praevisum imminens quicquid mali est.	su^bi^i_sse& pr[ae]vi&su&m i_mmi&ne_ns qvi&cqvi&d ma^li& e&st 	^^_X_X_X_X_^X	0.82
Euhoe, nefandus Livor infernas agit	[eu]h[oe] ne&fa_ndu&s li_vo&r i_nfe&rna_s a^gi&t 	X_X_X_X_X_^X	1.0
res pessime, ingrediens eburna vortices	re&s pe_ssi&me& i_ngre^di^e&ns e&bu_rna& vo_rti^ce&s 	X_X_^^_X_X_^X	1.0
Stygios sub afflatu usque concretos dedit	sty^gi^o&s su&b a_ffla&tu& u_sqve& co_ncre&to&s de^di&t 	^^_X_X_X_X_^X	1.0
in marmor; Alectoque atque ipse mutuis	i&n ma_rmo^r; a_le_cto_que& a_tque& i_pse& mu_tu^i&s 	X_X_X_X_X_^X	m
utrinque Gorgoneis venenis obsiti	u&tri_nqve& go_rgo^ne^i&s ve&ne_ni&s o_bsi^ti& 	X_X_^^_X_X_^X	1.0
sese efferunt in rabiem, et interior stupet	se&se& e_ffe&ru&nt i&n ra^bi^e&m e&t i_nte^ri^o&r stu^pe&t 	X_X_X^^X_^^_^X	1.0
Tartarea sedes ac tumultu contremit,	ta&rta^re^a& se_de&s a&c tu&mu_ltu& co_ntre^mi&t 	X^^X_X_X_X_^X	0.98
stridoreque ululatuque latrans Cerberus	stri&do_re&qve& u^lu^la&tu_qve& la_tra&ns ce_rbe^ru&s 	X_X^^X_X_X_^X	1.0
cedit metu. Quin rex et infernus metu	ce&di&t me&tu& qvi&n re&x e&t i_nfe&rnu&s me^tu& 	X_X_X_X_X_^X	1.0
una tyranno colla subclinat novo	u&na_ ty&ra_nno& co_lla& su_bcli&na_t no^vo& 	X_X_X_X_X_^X	1.0
novumque sontibus additum est poenae genus.	no&vu_mqve& so_nti^bu^s a_ddi&tu&m e&st p[oe]n[ae] ge^nu&s 	X_X_^^_X_X_^X	1.0
Sibi quisque tormentum alterius optet magis:	si^bi^ qvi_sqve& to_rme_ntu&m a_lte&ri^u^s o&pte&t ma^gi&s	^^_X_X_X^^X_^X	m
euhoe libes matresque nurusque heu libes!	[eu]h[oe] li^be&s ma_tre_sque^ nu^ru_sque& h[eu] li^be&s!	X_X_X_^^_X_^X	m
Iuppiter ab alto cuncta prospectans polo,	ju&ppi^te^r a&b a_lto& cu_ncta& pro_spe&cta&ns po^lo& 	X^^X_X_X_X_^X	1.0
vosque veteris Manes Masinisse pii,	vo_sque^ ve^te^ri&s ma_ne&s ma_si_ni_sse_ pi^i&, 	X^^X_X_X_X_^X	v
quibus parentandum bonis a me reor	qvi&bu&s pa&re_nta&ndu_m bo&ni_s a& me_ re^o&r 	X_X_X_X_X_^X	1.0
studiis et ad laudem quoque aemulo gradu,	stu^di^i_s e&t a&d l[au]de&m qvo&qve& [ae]mu&lo& gra^du& 	^^_X_X_X_X_^X	1.0
vosque patrii obtestor dii et deae libes:	vo_sqve^ pa^tri&i& o_bte_sto&r di^i& e&t de^[ae] li^be&s	X^^X_X_X_X_^X	v
non sponte me haec animo sed invitum mihi	no&n spo_nte& me& h[ae]c a^ni^mo_ se&d i_nvi&tu&m mi^hi& 	X_X_^^_X_X_^X	1.0
contra impios regnique consortes datos	co&ntra& i_mpi&o_s re&gni_qve& co_nso&rte_s da^to&s 	X_X_X_X_X_^X	1.0
sumpsisse odia. Sed evenit id usu quidem:	su&mpsi_sse& o&di^a^ se&d [eu]e&ni^t i^d u&su& qvi^de&m	X_X^^X_X^^X_^X	m
ut sole pix quae liquitur, eadem ab aestibus	u&t so_le^ pi&x qu[ae] li_qui^tu^r, e^a^de^m a^b [ae]sti^bu&s 	X_X_X_^^^^^^_^X	m
itemque itemque usta evitrescat horrida,	i&te_mqve& i&te_mqve& u&sta& e_vi&tre_sca&t ho_rri^da& 	X_X_X_X_X_^X	1.0
sic et virorum saepius animi exciti	si&c e&t vi^ro_ru&m s[ae]pi^u^s a^ni&mi& e_xci^ti& 	X_X_X_X^^X_^X	m
iniuriis, inviti inhorrescunt he heu.	i&nju_ri^i_s, i_nvi_ti& i^nho_rre_scu&nt he^ h[eu]. 	X_X_X_X_X_^X	m
Aude invidum domesticumque hostem tuum	[au]de& i_nvi&du&m do&me_sti&cu_mqve& ho&ste&m tu^u&m 	X_X_X_X_X_^X	1.0
hostem putare, piumque ducito fore	ho&ste&m pu^ta_re^ pi^u_mqve^ du_ci&to_ fo^re&	X_X_^^_X_X_^X	m
tuae referre dignitati quicquid im-	tu&[ae] re&fe_rre& di_gni&ta_ti& qvi_cqvi^d i&m 	X_X_X_X_X_^X	1.0
piis et improbis merentibus inferas.	pi&i_s e&t i_mpro&bi&s me&re_nti^bu^s i_nfe^ra&s 	X_X_X_X_^^_^X	1.0
Semper ne perferemus hoc: ut qui modis	se&mpe&r ne& pe_rfe&re_mu&s ho_c u&t qvi_ mo^di&s 	X_X_X_X_X_^X	1.0
nos omnibus laedere per invidiam parent,	no&s o_mni&bu&s l[ae]de^re^ pe&r i_nvi^di^a&m pa^re&nt 	X_X_X^^X_^^_^X	0.43
non sui aliquando iure poeniteat nefas?	no&n su^i& a^li&qva_ndo& ju_re& p[oe]ni^te^a_t ne^fa&s 	X^^X_X_X_^^_^X	1.0
Nunquam ne te tot atque tantis obrutum	nu&nqva&m ne& te_ to&t a_tqve& ta_nti&s o_bru^tu&m 	X_X_X_X_X_^X	1.0
iniuriis, Iugurtha, te ostendes virum?	i&nju_ri&i_s ju&gu_rtha& te& o_ste&nde&s vi^ru&m 	X_X_X_X_X_^X	1.0
Nunquam ne te posse aliquid in petulantium	nu&nqva&m ne& te_ po&sse& a^li^qvi&d i&n pe^tu^la_nti^u&m 	X_X_X^^X_^^_^X	1.0
protervitatem proferes? Livor scelus.	pro&te_rvi&ta_te&m pro_fe&re&s li&vo&r sce^lu&s 	X_X_X_X_X_^X	1.0
Aude, anime, superis non vetantibus diis,	[au]de& a^ni^me& su^pe^ri&s no&n ve&ta_nti&bu_s di^i&s 	X^^X^^X_X_X_^X	1.0
eumque presta te virum, qualem solet	e&u_mqve& pre_sta& te_ vi&ru&m qva&le&m so^le&t 	X_X_X_X_X_^X	1.0
armatus hostis metuere. An te forsitan	a&rma_tu&s ho_sti&s me^tu^e&re& a&n te& fo_rsi^ta&n 	X_X_X^^X_X_^X	1.0
ignobili editum parente scilicet	i&gno_bi&li& e_di&tu&m pa&re_nte& sci_li^ce&t 	X_X_X_X_X_^X	1.0
fastidiunt proceres? Sumus cuncti a Iove.	fa&sti_di&u_nt pro^ce^re&s su&mu&s cu&ncti& a_ jo^ve& 	X_X_^^_X_X_^X	1.0
Sed mea perinde me satis virtus fovet	se&d me^a^ pe&ri_nde& me_ sa&ti&s vi&rtu&s fo^ve&t 	X^^X_X_X_X_^X	1.0
satisque, quisquis ille sit, sibi met genus	sa&ti_sqve& qvi_sqvi&s i_lle& si&t si^bi^ me_t ge^nu&s 	X_X_X_X_^^_^X	0.81
dignum parat, quem victor orbis comprobet	di&gnu&m pa&ra&t qve&m vi_cto&r o_rbi&s co_mpro^be&t 	X_X_X_X_X_^X	1.0
populus. Mea haec laus atque nobilitas mea est.	po^pu^lu&s me&a& h[ae]c l[au]s a_tqve& no_bi^li^ta&s me^a& e&st 	^^_X_X_X_^^_^X	0.84
Non id meum est sed patris, Hyempsal, dedecus,	no&n i&d me&u&m e&st se&d pa_tri^s hy^e_mpsa&l de_de^cu&s 	X_X_X_^^_X_^X	m
si dedecus talem edidisse filium,	si& de_de&cu&s ta&le&m e_di&di_sse& fi_li^u&m 	X_X_X_X_X_^X	1.0
qualem Micissa, si rogetur, liberum	qva&le&m mi&ci_ssa& si_ ro&ge_tu&r li_be^ru&m 	X_X_X_X_X_^X	1.0
quam quos habet multo editum malit sibi.	qva&m qvo_s ha&be&t mu&lto& e_di&tu&m ma&li&t si^bi& 	X_X_X_X_X_^X	1.0
At vero ego patre proinde non certo satos	a&t ve_ro& e^go^ pa_tre^ pro^i_nde^ no&n ce_rto_ sa^to&s 	X_^^_^^_X_X_^X	m
arbitror eos, qui tam impares se pristinis	a_rbi^tro^r e^o&s, qvi_ ta&m i_mpa^re&s se& pri_sti^ni&s 	X^^X_X_X_X_^X	c
nostrae familiae moribus nunc praebeant.	no&str[ae] fa&mi^li^[ae] mo_ri&bu&s nu&nc pr[ae]be^a&nt	X_X^^X_X_X_^X	m
Uter Masinissae est avo similis magis,	u&te&r ma_si_ni_ssae& e&st a^vo_  si^mi^li&s ma^gi&s, 	X_X_X_X_^^_^X	v
illi ne qui superbia atque ignavia	i&lli_ ne& qvi_ su&pe_rbi&a& a_tqve& i&gn[au]i^a& 	X_X_X_X_X_^X	1.0
degunt iuventam, an et Iugurtha? Qui quidem	de&gu&nt ju&ve_nta&m a&n e&t ju&gu_rtha& qvi& qvi^de&m 	X_X_X_X_X_^X	1.0
his artibus quibus imperium avus nactus est,	hi&s a_rti&bu&s qvi^bu^s i_mpe&ri^u&m a^vu&s na_ctu^s e&st 	X_X_^^_X^^X_^X	1.0
pridem integrum libycum merebar unicus?	pri&de&m i_nte&gru&m li^by^cu&m me&re_ba&r u_ni^cu&s 	X_X_^^_X_X_^X	1.0
Meam ego meo labore partam gloriam	me&a&m e^go^ me&o_ la&bo_re& pa_rta&m glo_ri^a&m 	X^^X_X_X_X_^X	1.0
nostrae ad familiae contuli certum decus.	no&strae& a&d fa&mi^li^[ae] co_ntu&li_ ce&rtu&m de^cu&s	X_X^^X_X_X_^X	m
Illi hunc perisse optant virum cuius micat	i&lli& hu&nc pe&ri_sse& o&pta&nt vi&ru&m cu&ju&s mi^ca&t 	X_X_X_X_X_^X	1.0
splendore domus: omnis et honos titulis nitet.	sple&ndo_re& do^mu^s o&mni^s e^t ho&no&s ti^tu^li&s ni^te&t	X_X^^X^^X_^^_^X	m
Verum, ut aiunt, quod agas agito pro viribus.	ve_ru^m, u^t a_ju&nt, quo^d a^ga_s a^gi^to& pro_ vi_ri^bu&s. 	X^^X_^^_^^_X_^X	m
Iuvabit interim simulasse id artibus.	iu&va_bi^t i_nte&ri&m si^mu^la_sse& i&d a_rti^bu&s. 	X_X_X_^^_X_^X	v
Regni labes est principum discordia.	re_gni_ la_be_s e&st pri_nci^pu&m di_sco_rdi^a&. 	X_X_X_X_X_^X	v
Cum principes ipsi mali sint, id boni	cu&m pri_nci&pe_s i&psi_ ma&li_ si&nt i&d bo^ni& 	X_X_X_X_X_^X	1.0
optent. Bene usquam nulla successit bonis	o&pte&nt be&ne& u_sqva&m nu_lla& su_cce&ssi&t bo^ni&s 	X_X_X_X_X_^X	1.0
res, quae ocium perturbet inde publicum.	re&s qv[ae] o_ci&u_m pe&rtu_rbe&t i_nde& pu_bli^cu&m 	X_X_X_X_X_^X	1.0
Si dura tempora fuerint et principes	si_ du_ra^ te_mpo&ra^ fu^e^ri&nt e&t pri_nci^pe&s	X_X_X^^X_X_^X	m
ipsi mali rempublicam gerant male,	i&psi_ ma&li_ re&mpu_bli&ca_m ge&ra&nt ma^le& 	X_X_X_X_X_^X	1.0
quis audeat praestare se civem bonum?	qvi&s [au]de&a&t pr[ae]sta_re& se_ ci&ve&m bo^nu&m 	X_X_X_X_X_^X	1.0
Quisquis bonum se se esse civem quam vide-	qvi&sqvi&s bo&nu&m se& se& e_sse& ci_ve&m qva&m vi^de& 	X_X_X_X_X_^X	1.0
ri malit, ad bene agendum habet semper bona	ri& ma_li&t a&d be^ne& a^ge_ndu&m ha&be&t se&mpe&r bo^na& 	X_X_^^_X_X_^X	1.0
is ipse tempora, et homo frugi, quisquis est,	i&s i_pse& te_mpo&ra& e^t ho^mo& fru_gi& qvi_sqvi^s e&st 	X_X_X^^X_X_^X	1.0
sibi unico haud duros putet eos principes,	si&bi& u_ni&co h[au]d du&ro&s pu^te^t e^o&s pri_nci^pe&s	X_X_X_X^^X_^X	m
quos et populus omnis ferat. Suo in malo	qvo&s e&t po&pu^lu^s o&mni&s fe&ra&t su&o& i&n ma^lo& 	X_X^^X_X_X_^X	0.5
nemo quidem luget aliorum lachrymis.	ne&mo& qvi&de&m lu&ge^t a^li&o_ru&m la_chry^mi&s 	X_X_X^^X_X_^X	1.0
Quaeque mala sunt muta atque mox fient bona.	qv[ae]qve^ ma^la& su&nt mu&ta& a_tqve& mo&x fi&e&nt bo^na& 	X^^X_X_X_X_^X	0.94
Erunt bona ipsos quaeque delectant bonos.	e&ru&nt bo&na& i_pso&s qv[ae]qve& de_le&cta&nt bo^no&s 	X_X_X_X_X_^X	1.0
Hoc ego nihil placere placatis scio	ho&c e^go^ ni&hi&l pla&ce_re& pla_ca&ti&s sci^o& 	X^^X_X_X_X_^X	0.03
civibus et intimis dolere probos ani-	ci&vi^bu^s e^t i_nti&mi&s do^le_re^ pro^bo_s a^ni& 	X^^X_X_X_^^_^X	m
mis: regulos gaza atque sedibus ocyus	mi&s re_gu^lo&s ga&za& a_tqve^ se_di^bu^s o_cy^u&s	X_X_X_X_^^_^X	m
sectis temere et abisse diversos locis.	se&cti&s te&me^re& e^t a&bi_sse& di_ve&rso&s lo^ci&s 	X_X^^X_X_X_^X	1.0
Qui dissident animis, eadem aegre queunt	qvi& di_ssi&de&nt a^ni^mi_s e&a_de&m [ae]gre& qve^u&nt 	X_X_^^_X_X_^X	0.07
umbra tegi. Ni aliquo tenentur invicem	u&mbra_ te&gi_ ni& a^li^qvo_ te&ne_ntu&r i_nvi^ce&m 	X_X_^^_X_X_^X	1.0
animi usque vinculo, haud coherent insimul.	a^ni^mi& u_sqve& vi_ncu&lo& h[au]d co&he_re&nt i_nsi^mu&l 	^^_X_X_X_X_^X	1.0
Tum si Iugurtham, si satis novi virum,	tu&m si_ ju&gu_rtha&m si_ sa&ti&s no&vi_ vi^ru&m 	X_X_X_X_X_^X	1.0
tandem is vereor nequid ferus acerbi paret:	ta&nde&m i^s ve^re&o&r ne&qvi&d fe&ru^s a^ce&rbi_ pa^re&t 	X^^X_X_X^^X_^X	m
stat frons ei vultusque pallentes gravi	sta&t fro&ns e^i_ vu_ltu_sque^ pa_lle_nte&s gra^vi_ 	X_X_X_X_X_^X	m
cura igneoque furore suffuse genae.	cu&ra& i_gne^o_qve^ fu^ro_re^ su_ffu&se_ ge^n[ae]	X_X_^^_X_X_^X	m
Latet quid alta mente subvolvat mali,	la&te&t qvi&d a_lta& me_nte& su_bvo&lva_t ma^li& 	X_X_X_X_X_^X	0.82
neque temere illud est quod impexam comam	ne&qve^ te^me&re& i_llu&d e&st qvo&d i_mpe&xa&m co^ma&m 	X^^X_X_X_X_^X	1.0
secum ipse iam tum inmurmurans quassat suam.	se&cu&m i_pse& ja&m tu&m i&nmu_rmu&ra_ns qva&ssa&t su^a&m 	X_X_X_X_X_^X	1.0
Animo ubi sunt alto viri usquam praediti,	a&ni^mo& u^bi& su&nt a&lto_ vi&ri& u_sqva&m pr[ae]di^ti& 	X^^X_X_X_X_^X	1.0
semper animis secum alta versant ac parant.	se&mpe^r a^ni&mi&s se&cu&m a_lta& ve_rsa&nt a&c pa^ra&nt 	X^^X_X_X_X_^X	1.0
Sperasseque et de fortibus viris bene	spe&ra_sse^que& e&t de& fo_rti^bu&s vi&ri&s be^ne& 	X_X_X_X_X_^X	m
multo magis quam metuere satis condecet.	mu&lto_ ma&gi&s qva&m me^tu^e&re^ sa^ti&s co_nde^ce&t 	X_X_X^^X^^X_^X	1.0
Proinde privati domum curent suam,	pro^i_nde^ pri_va_ti_ do^mu&m cu_re&nt su^a&m, 	X_X_X_X_X_^X	m
rempublicam reges suo curent gradu.	re&mpu_bli&ca_m re&ge&s su&o_ cu&re&nt gra^du& 	X_X_X_X_X_^X	1.0
Metus an dolor vexet magis mortalium	me^tu^s a&n do&lo&r ve&xe&t ma&gi&s mo&rta_li^u&m 	^^_X_X_X_X_^X	0.67
animos apud me non quidem constat satis.	a^ni^mo_s a&pu&d me& no&n qvi&de&m co&nsta&t sa^ti&s 	^^_X_X_X_X_^X	1.0
Ita me vel invitum novae deum minae	i^ta^ me_ ve&l i_nvi&tu&m no&v[ae] de&u&m mi^n[ae] 	^^_X_X_X_X_^X	1.0
exterritum ante ora positae longe premunt.	e&xte_rri&tu&m a_nte& o&ra^ po^si&t[ae] lo&nge& pre^mu&nt 	X_X_X^^X_X_^X	m
O Polymites, o et interpres deum,	o_ po_ly^mi_te_s, o_ e^t i_nte_rpre&s de^u&m, 	X_X_X_X_X_^X	m
quid est quod apportas novi? Libyae luem,	qvi&d e&st qvo&d a_ppo&rta_s no&vi_ li^by^[ae] lu^e&m 	X_X_X_X_^^_^X	1.0
siqua est malis adhibenda portentis fides.	si&qva& e&st ma&li_s a^dhi^be_nda& po_rte&nti_s fi^de&s 	X_X_^^_X_X_^X	1.0
Virtute consilioque praestans ac potens,	vi&rtu_te& co_nsi^li^o_qve& pr[ae]sta&ns a&c po^te&ns 	X_X_^^_X_X_^X	1.0
similis tibi vir frontem ubi suam gravem	si^mi^li&s ti&bi_ vi&r fro_nte&m u&bi& su&a&m gra^ve&m 	^^_X_X_X_X_^X	0.15
portendit, arduas adesse res liquet.	po&rte_ndi&t a_rdu&a_s a&de_sse& re&s li^qve&t 	X_X_X_X_X_^X	1.0
O patria, patria, sic ne sacrarum aedium	o& pa_tri^a^ pa_tri^a^ si&c ne& sa_cra&rum [ae]di^u&m 	X_^^_^^_X_X_^X	m
insigne culmen turbine avulsum ruit?	i&nsi_gne& cu_lme&n tu_rbi&ne& [au]u&lsu&m ru^i&t 	X_X_X_X_X_^X	1.0
Ex ultimo aenei colossi vertice	e&x u_lti^mo [ae]ne^i_ co^lo_ssi_ ve_rti^ce& 	X_X_X_X_X_^X	m
lateque fuseque albicantes ignium	la&te_qve& fu_se&qve& a_lbi&ca_nte&s i_gni^u&m 	X_X_X_X_X_^X	1.0
arsere flammae. Fertur et formiceis	a_rse_re^ fla_mm[ae]. fe_rtu^r e&t fo_rmi_ce^i&s 	X_X_X_X_X_^X	m
populis vagis horrere pulvinar deum.	po^pu^li&s va&gi_s ho&rre_re& pu_lvi&na&r de^u&m 	^^_X_X_X_X_^X	1.0
Ruptisque vinclis, taurus excaepto fugax	ru&pti_sqve& vi_ncli&s t[au]ru&s e_xc[ae]pto_ fu^ga&x 	X_X_X_X_X_^X	1.0
cervice ferro cessit ex ara petens	ce&rvi_ce& fe_rro& ce_ssi&t e&x a&ra_ pe^te&ns 	X_X_X_X_X_^X	1.0
cruore sparsos regios iuvenes suo.	cru^o_re^ spa_rso&s re_gi^o_s iu^ve^ne&s su^o_. 	X_X_X_X_^^_^X	v
Quin etiam Hyempsal ipse, prodiens domo	qvi&n e^ti^a&m hy&e_mpsa&l i_pse& pro_di&e_ns do^mo& 	X^^X_X_X_X_^X	1.0
pollice sub illiso moleste limiti,	po&lli^ce^ su&b i_lli&so_ mo&le_ste& li_mi^ti& 	X^^X_X_X_X_^X	1.0
faciem in suam pronus propere lapsus gemit.	fa^ci^e&m i&n su^a&m pro&nu&s pro^pe^re_ la&psu&s ge^mi&t 	^^_X_X_^^_X_^X	v
Incendiariaque avis alta a porticu	i&nce_ndi&a_ri&a^qve& a^vi&s a_lta& a& po_rti^cu& 	X_X_X^^X_X_^X	m
volitans patrum simulacra polluit aurea.	vo^li^ta&ns pa&tru&m si^mu^la_cra& po_llu^i^t [au]re^a& 	^^_X_^^_X_^^_^X	0.98
Accursito ut vatem deumque interpretem	a&ccu_rsi&to& u&t va&te&m de&u_mqve& i&nte_rpre^te&m 	X_X_X_X_X_^X	1.0
hunc certiorem Polymitem de novis	hu&nc ce_rti&o_re&m po_ly&mi_te&m de_ no^vi&s 	X_X_X_X_X_^X	1.0
mirisque rebus ordine faciam celer.	mi&ri_sqve& re_bu&s o_rdi&ne^ fa^ci&a&m ce^le&r 	X_X_X_X^^X_^X	1.0
Meliora superi! Res inauditas fero.	me^li^o_ra& su^pe^ri& re_s i&n[au]di&ta_s fe^ro& 	^^_X^^X_X_X_^X	1.0
Malo malum congruit. At emori expedit,	ma&lo_ ma&lu&m co&ngru^i^t a&t e_mo&ri& e_xpe^di&t 	X_X_X^^X_X_^X	1.0
o Polymites. Quid ita? Tanta nos mala	o& po_ly&mi_te&s qvi^d i^ta& ta_nta& no&s ma^la& 	X_X_X^^X_X_^X	0.94
coram obsident. Imo et quidem vel maxime	co&ra&m o_bsi&de&nt i&mo& e&t qvi&de&m ve&l ma_xi^me& 	X_X_X_X_X_^X	1.0
superesse nunc expedit, ut inde vincere	su^pe^re_sse& nu&nc e&xpe^di^t u&t i_nde& vi_nce^re& 	^^_X_X^^X_X_^X	0.98
malum ferendo denique assuescas magis.	ma&lu&m fe^re_ndo_ de_ni^que& a_ssve_sca&s ma^gi&s. 	X_X_X_X_X_^X	v
O te virum fortem, ipse si factis tibi	o& te_ vi&ru&m fo&rte&m i_pse& si_ fa&cti&s ti^bi& 	X_X_X_X_X_^X	1.0
aeque atque dictis es! Etenim ex dictis probe	[ae]qve& a_tqve& di_cti&s e^s e^te&ni&m e&x di&cti&s pro^be& 	X_X_X^^X_X_^X	m
egisse discimus. At quid apportas novi?	e&gi_sse& di_sci^mu^s a&t qvi&d a_ppo&rta_s no^vi& 	X_X_^^_X_X_^X	0.64
Iras deum: nam busta patrum regia	i&ra&s de&u&m na&m bu_sta& pa_tru&m re_gi^a& 	X_X_X_X_X_^X	0.42
sanctaque sepulcra sponte aperta ex ultimis	sa&ncta^qve^ se&pu_lcra& spo_nte& a&pe_rta& e&x u_lti^mi&s 	X^^X_X_X_X_^X	m
imisque sedibus usque tertii Iovis	i&mi_sqve& se_di^bu^s u_sqve& te_rti&i_ jo^vi&s 	X_X_^^_X_X_^X	1.0
dedere gemitum ac iurgio altercarier	de&de_re& ge^mi^tu&m a&c ju_rgi&o& a_lte&rca_ri^e&r 	X_X^^X_X_X_^X	1.0
circum theatra larvulas visas ferunt.	ci&rcu&m the&a_tra& la_rvu&la_s vi&sa&s fe^ru&nt 	X_X_X_X_X_^X	1.0
En et sacelli veteris obversas fores	e&n e&t sa&ce_lli& ve^te^ri&s o_bve&rsa_s fo^re&s 	X_X_X^^X_X_^X	1.0
lemures tenere laremque regium deum	le^mu^re_s te&ne_re^ la^re_mqve& re_gi&u&m de^u&m 	^^_X_^^_X_X_^X	1.0
crepitu strepentique sonitu triclinia	cre^pi^tu& stre&pe_nti&qve^ so^ni&tu& tri_cli_ni^a&	^^_X_X^^X_X_^X	m
cuncta labefactare atque mixtim sedibus	cu&ncta^ la^be&fa_cta&re& a_tqve& mi_xti&m se_di^bu&s	X^^X_X_X_X_^X	m
ultro citro mutatis Penates propalam	u_ltro^ ci^tro& mu_ta_ti&s pe^na_te&s pro_pa^la&m 	X^^X_X_X_X_^X	c
migrasse, multaque alia tetra atque horrida	mi&gra_sse& mu_lta&qve& a^li^a& te_tra& a&tqve& ho_rri^da& 	X_X_X^^X_X_^X	1.0
et visa et audita optimi patres ferunt.	e&t vi_sa& e&t [au]di&ta& o_pti&mi_ pa&tre&s fe^ru&nt 	X_X_X_X_X_^X	1.0
Vos quaeso me, o proceres, labans ne corruam	vo&s qv[ae]so& me& o& pro^ce^re&s la&ba&ns ne& co_rru^a&m 	X_X_^^_X_X_^X	1.0
tenete: ruo, ruo. Quippe spiritus fugit,	te^ne_te^: ru^o^, ru^o^. qui_ppe^ spi_ri&tu&s fu^gi&t, 	X_^^^^^_^_X_^X	m
totumque nervi animique deficiunt. Humi	to&tu_mqve& ne_rvi& a^ni^mi_qve& de_fi^ci^u&nt hu^mi& 	X_X_^^_X_^^_^X	1.0
consternor et oculi et genua fluunt simul:	co&nste_rno&r e^t o^cu&li& e&t ge&nu^a^ flu&u&nt si^mu&l 	X_X^^X_X^^X_^X	m
tantus dolor metus ve me rerum tenet.	ta&ntu&s do&lo&r me&tu&s ve& me_ re&ru&m te^ne&t 	X_X_X_X_X_^X	1.0
Hinc illud est, o Polymites, quod solet	hi&nc i_llu&d e&st o& po_ly&mi_te&s qvo&d so^le&t 	X_X_X_X_X_^X	1.0
dici: viros doctos, ut es tu, fortiter	di&ci_ vi&ro&s do&cto_s u&t e&s tu& fo_rti^te&r 	X_X_X_X_X_^X	1.0
de rebus asperis ferendis dicere,	de& re_bu&s a_spe&ri&s fe&re_ndi&s di_ce^re& 	X_X_X_X_X_^X	1.0
nescisse tamen adversa, sicut caeteri	ne&sci_sse& ta^me^n a&dve_rsa& si_cu&t c[ae]te^ri& 	X_X^^X_X_X_^X	1.0
homines solent, non ferre tandem molliter.	ho^mi^ne&s so&le&nt no&n fe_rre& ta_nde&m mo_lli^te&r 	^^_X_X_X_X_^X	1.0
Verum quid est quod pro re agendum censeas?	ve&ru&m qvi&d e&st qvo&d pro_ re& a&ge_ndu&m ce_nse^a&s 	X_X_X_X_X_^X	1.0
Votis deos mox esse placandos reor,	vo&ti&s de&o&s mo&x e_sse& pla_ca&ndo&s re^o&r 	X_X_X_X_X_^X	1.0
lustranda passim templa, iustitium urbibus	lu&stra_nda& pa_ssi&m te_mpla& ju_sti^ti^u&m u_rbi^bu&s 	X_X_X_X_^^_^X	1.0
ubilibet indicendum; et inde ego hinc simul	u&bi^li^be^t i_ndi&ce_ndu&m e^t i_nde& e&go& hi&nc si^mu&l	X^^X_X_X_X_^X	m
secedo, me quo linteis sacris parem.	se&ce_do& me& qvo& li_nte&i&s sa&cri&s pa^re&m 	X_X_X_X_X_^X	1.0
Vos et sequimini. Supplices movent deos!	vo&s e&t se^qvi^mi^ni& su_ppli^ce&s mo&ve&nt de^o&s	X_X^^X_X_X_^X	m
Confecta pulchre res mihi ex sententia est.	co&nfe_cta& pu_lchre& re&s mi&hi& e&x se&nte_nti^a& e&st 	X_X_X_X_X_^X	1.0
Nam me Invidia mater Herebo accitam ultimo	na&m me& i_nvi&di^a^ ma&te^r he^re&bo& a_cci&ta&m u_lti^mo& 	X_X^^X^^X_X_^X	m
complexa dudum et suavio libans suo:	co&mple_xa^ du_du&m e&t sva_vi^o_ li&ba&ns su^o&	X_X_X_X_X_^X	v
'O,’ inquit, 'omne, o unicum decus meum,	'o_,’ i_nqvi^t, 'o_mne&, o_ u_ni^cu&m de&cu&s me^u&m, 	X_X_X_X_X_^X	m
Discordia, modo prebeas te ipsam mihi	di&sco_rdi&a^ mo^do& pre_be&a&s te& i&psa&m mi^hi& 	X_X^^X_X_X_^X	m
facilem atque morigeram! Opus est ad id rei	fa^ci^le&m a_tque^: mo_ri&ge^ra&m! o^pu^s e&st a^d i&d re^i& 	^^_X_X^^X_X_^X	m
quam dignitatis gratia meae paro.	qva&m di_gni&ta_ti&s gra_ti&a_ me&[ae] pa^ro& 	X_X_X_X_X_^X	1.0
Genus hoc enim Numidiae et tumidum et ferox	ge^nu^s ho_c e&ni&m nu&mi_di&[ae] e&t tu^mi^du&m e&t fe^ro&x 	^^_X_X_X_^^_^X	1.0
et insolens odi. Id quidem cum caeteras	e&t i_nso&le_ns o&di& i&d qvi&de&m cu&m c[ae]te^ra&s 	X_X_X_X_X_^X	1.0
ob res tum eo quod Ambitio dea, quam unice	o&b re&s tu&m e&o& qvo&d a_mbi^ti^o_ de^a^ qva&m u_ni^ce& 	X_X_X_^^_^^_^X	m
perisse cupio, a se recepta splendidis	pe&ri_sse& cu^pi^o& a& se_ re&ce_pta& sple_ndi^di&s 	X_X^^X_X_X_^X	1.0
colitur honoribus, aureo praestans gradu.	co&li^tu^r ho^no_ri^bu^s, [au]re^o& pr[ae]sta&ns gra^du_. 	X^^X_^^_X_X_^X	m
Proinde decretum est apud me funditus	pro^i_nde^ de_cre_tu&m e&st a^pu&d me_ fu_ndi^tu^s 	X_X_X_X_X_^X	m
delere gentem. Fuerit officium tuum	de&le_re& ge_nte&m fu^e^ri&t o_ffi^ci^u&m tu^u&m 	X_X_X^^X_^^_^X	1.0
matri obsequi praesertim in hac causa mea,	ma&tri& o_bse&qvi_ pr[ae]se_rti&m i&n ha&c c[au]sa_ me^a& 	X_X_X_X_X_^X	1.0
qua, si sit opus, equidem et mori, ut tandem meo	qua&, si_ si^t o^pu^s, e^qui^de&m e&t mo&ri&, u&t ta_nde&m me^o&	X_^^^^^_^_X_^X	m
satis furori fiat, audens expetam.'	sa&ti&s fu&ro_ri& fi_a&t [au]de&ns e_xpe^ta&m 	X_X_X_X_X_^X	1.0
Haec ubi parens me mea precatur lachrymans,	h[ae]c u^bi^ pa&re&ns me& me^a^ pre&ca_tu&r la_chry^ma&ns 	X^^X_X^^X_X_^X	1.0
per Styga, per infernas paludes, per grave	pe&r sty^ga^ pe&r i_nfe&rna&s pa&lu_de&s pe&r gra^ve& 	X^^X_X_X_X_^X	1.0
pallentis atrae noctis horrendum caput	pa&lle_nti&s a_tr[ae] no_cti&s ho_rre&ndu&m ca^pu&t 	X_X_X_X_X_^X	1.0
iuravi et obstrinxi volens pro viribus	ju&r[au]i& e&t o_bstri&nxi_ vo&le&ns pro& vi_ri^bu&s 	X_X_X_X_X_^X	1.0
me prorsus acturam, mea ut noscar parens	me& pro_rsu&s a_ctu&ra_m me&a& u&t no&sca&r pa^re&ns 	X_X_X_X_X_^X	0.97
quid ego sibi a me iure deberi putem,	qvi&d e^go^ si&bi& a_ me& ju_re& de_be&ri_ pu^te&m 	X^^X_X_X_X_^X	1.0
quidve artibus meis in hominum denique	qvi&dve& a_rti&bu&s me&i_s i&n ho^mi^nu&m de_ni^qve& 	X_X_X_X^^X_^X	1.0
possim luem Discordia. Ergo ex abdito	po&ssi&m lu&e&m di&sco_rdi&a& e_rgo& e&x a_bdi^to& 	X_X_X_X_X_^X	1.0
Orco mihi socios truces ad horridum	o&rco_ mi&hi^ so^ci&o&s tru&ce_s a&d ho_rri^du&m	X_X^^X_X_X_^X	m
coexequendum facinus eductos agens	co&e_xe^que_ndu&m fa^ci^nu^s e_du_cto_s a^ge&ns 	X_X_X^^X_X_^X	m
exercui ac passim pallantes late agros	e_xe_rcu^i& a&c pa_ssi&m pa_lla_nte&s la_te& a^gro&s 	X_X_X_X_X_^X	m
tectaque furore et pessima opplevi lue.	te&cta^qve^ fu&ro_re& e&t pe_ssi&ma& o_pple&vi_ lu^e& 	X^^X_X_X_X_^X	m
Sed ecce Perfidia uti prona est ad scelus!	se&d e_cce& pe_rfi^di^a& u_ti& pro_na& e&st a&d sce^lu&s 	X_X_^^_X_X_^X	m
Viden quibus se se dolis, qua fronte, quo	vi&de&n qvi&bu&s se& se_ do&li&s qva& fro_nte^ qvo& 	X_X_X_X_X_^X	1.0
vultu atque gestu penitus ostentat piam?	vu&ltu& a_tqve& ge_stu& pe^ni^tu&s o_ste&nta&t pi^a&m 	X_X_X^^X_X_^X	1.0
En iri obindutam aurea ferro igneque	e&n i_ri& o&bi_ndu&ta&m [au]re&a_ fe&rro& i_gne^qve& 	X_X_X_X_X_^X	0.98
malo et veneno subter armatam deam,	ma&lo& e&t ve&ne_no& su_bte&r a_rma&ta&m de^a&m 	X_X_X_X_X_^X	1.0
quae quidem hominum sensim per astum ambit greges.	qv[ae] qvi^de&m ho^mi&nu&m se&nsi&m pe&r a_stu&m a&mbi&t gre^ge&s 	X^^X_X_X_X_^X	1.0
Quae facto opus fuere belle exegimus.	qv[ae] fa_cto& o&pu&s fu&e_re& be_lle& e&xe_gi^mu&s 	X_X_X_X_X_^X	1.0
Nam res eo ducta est loci ut satellites	na&m re_s e&o_ du&cta& e&st lo&ci& u&t sa&te_lli^te&s 	X_X_X_X_X_^X	1.0
noctu Iugurthae in Hyempsalis domum dolis	no&ctu_ ju&gu_rth[ae] i^n hy^e_mpsa&li_s do&mu&m do^li&s 	X_X_^^_X_X_^X	1.0
irruperint illicque diversi ocyus	i&rru_pe&ri_nt i&lli_cqve& di_ve&rsi& o_cy^u&s 	X_X_X_X_X_^X	1.0
regem frequentes quaeritant, internecant.	re&ge&m fre&qve_nte&s qv[ae]ri&ta_nt i&nte_rne^ca&nt 	X_X_X_X_X_^X	1.0
Alii oscitantis dormientisque obvios	a^li^i& o_sci&ta_nti&s do_rmi&e_nti&sqve& o_bvi^o&s 	^^_X_X_X_X_^X	1.0
omnes et impetu et mucrone competunt,	o_mne_s e^t i_mpe^tu& e&t mu_cro_ne^ co_mpe^tu&nt, 	X_X_X_X_X_^X	v
mactant et inversos tenus sternunt solo.	ma&cta&nt e&t i_nve&rso&s te&nu&s ste&rnu&nt so^lo& 	X_X_X_X_X_^X	0.71
Scrutari et alii abdita, alii diffringere	scru&ta_ri& e&t a^li^i& a&bdi^ta& a^li&i_ di&ffri_nge^re& 	X_X^^X^^X_X_^X	1.0
clausa loca non cessant; domusque omnis simul	cl[au]sa^ lo^ca^ no&n ce&ssa&nt do&mu_sqve& o&mni&s si^mu&l 	X^^X_X_X_X_^X	m
cadentium gemitu et fragore et aspero	ca&de_nti&u&m ge^mi^tu& e&t fra&go_re& e&t a_spe^ro& 	X_X_^^_X_X_^X	1.0
plagis tumultu exterrita intus volvitur.	pla&gi&s tu&mu_ltu& e&xte_rri&ta& i_ntu&s vo_lvi^tu&r 	X_X_X_X_X_^X	1.0
Tandem repertum Hyempsalem opprimunt, caput	ta&nde&m re&pe_rtu&m hy&e_mpsa&le&m o_ppri&mu&nt ca^pu&t 	X_X_X_X_X_^X	1.0
ferro amputant. Res hunc igitur acta in modum est.	fe&rro& a_mpu&ta&nt re&s hu&nc i&gi^tu^r a&cta& i&n mo^du&m e&st 	X_X_X_X^^X_^X	m
Ego nunc et ad comites revertor ut exequar	e^go^ nu&nc e&t a&d co^mi^te&s re&ve_rto^r u^t e_xe^qva&r 	^^_X_^^_X_^^_^X	1.0
ex instituto reliqua, ut hinc et plenius	e&x i_nsti^tu_to_ re^li^qua&, u^t hi&nc e&t ple_ni^u&s 	X_X_X^^X_X_^X	m
vestram libidinem expleam. Adducam mihi	ve&stra&m li&bi_di&ne&m e_xple&a&m a_ddu&ca&m mi^hi& 	X_X_X_X_X_^X	1.0
et Inopiam et Furtum et Rapinam concitas,	e&t i^no^pi^a&m e&t fu&rtu&m e&t ra^pi_na&m co_nci^ta&s	X^^X_X_X_X_^X	m
quarum opera huic calamitas genti magis	qua_ru^m o^pe^ra^ hu^i&c ca^la^mi^ta&s ge_nti_ ma^gi&s 	X^^X^^X^^X_X_^X	m
magisque dura sit. Ergo matura. Obsequor.	ma&gi_sqve& du_ra^ si^t e_rgo& ma_tu&ra& o_bse^qvo&r 	X_X_^^_X_X_^X	1.0
Ego vero ad Invidiam parentem pervolo.	e^go^ ve_ro& a&d i_nvi^di^a&m pa&re_nte&m pe_rvo^lo& 	^^_X_^^_X_X_^X	1.0
Ite io, matronae, et sacrum et opacum in nemus	i&te& i_o& ma_tro&n[ae] e&t sa&cru&m e^t o^pa&cu&m i&n ne^mu&s 	X_X_X_X^^X_^X	0.44
io demus hunc celebrem simul Baccho diem!			u
Io Bacche, formose io matrone io!	i^o_ ba_cche_, fo_rmo_se& i^o_ ma_tro_ne& i^o_! 	X_X_X_X_X_^X	m
Tu flamen aereae Tonantis coniugi,	tu& fla_me&n [ae]re&ae_ to&na_nti&s co_nju^gi& 	X_X_X_X_X_^X	1.0
matri deum tu, Galle, plaudito Cybeli.	ma&tri_ de&u&m tu& ga_lle& pl[au]di&to^ cy^be^li& 	X_X_X_X_X^^^X	1.0
Vos et pudicae virgines mecum lybes	vo&s e&t pu&di_cae& vi_rgi&ne&s me&cu&m ly^be&s 	X_X_X_X_X_^X	1.0
patrios deos placate votis thureque,	pa^tri^o&s de^o&s pla&ca_te& vo_ti&s thu_re^qve&	^^_X_X_X_X_^X	v
quatite io thyrsos, quatite pulchro deo.	qva&ti^te^ i^o& thy&rso&s qva^ti^te^ pu&lchro_ de^o& 	X^^X_X_X^^X_^X	m
Simul io matrone, io Bacche inclite!			u
Io Libes, Libes, io parens, parens,	i&o_ li&be_s li&be_s i&o_ pa&re&ns pa^re&ns 	X_X_X_X_X_^X	0.97
Ditique Manibusque litandum tibi!	di&ti_que^ ma_ni^bu_sque^ li_ta_ndu&m ti^bi&! 	X_X_X_X_X_^X	m
Ferale Phytonissae abigite omen, dei.	fe&ra_le^ phy^to^ni&ss[ae] a_bi^gi_te& o&me&n de^i& 	X_^^^^X_X_X_^X	m
Quid penditis, matronae? Agite Baccho diem	qvi&d pe_ndi&ti&s ma&tro_nae& a&gi^te^ ba&ccho_ di^e&m	X_X_X_X^^X_^X	m
sacrum, agite festum, io agite Bacho diem!	sa&cru&m, a^gi^te^ fe_stu&m, i^o_ a^gi^te^ ba_cho_ di^e&m! 	X^^X_X_X^^X_^X	m
Io Libes, io Libes, misere Libes,	i&o_ li&be_s i&o_ li&be_s mi^se^re_ li^be&s 	X_X_X_X_^^_^X	0.08
ululatibus luctuque complenda est dies.	u^lu^la_ti&bu&s lu&ctu_qve& co_mple&nda& e&st di^e&s 	^^_X_X_X_X_^X	1.0
Me miseram! Id omen horridum quemnam petit?	me& mi^se^ra&m i&d o_me&n ho_rri&du&m qve&mna&m pe^ti&t 	X^^X_X_X_X_^X	1.0
Qui nuncium, prout fertur, apportat malum,	qvi& nu_nci&u_m pr[ou]t fe_rtu&r a_ppo&rta&t ma^lu&m 	X_X_X_X_X_^X	0.72
is, commodus etiam si eat, molestus est.	i&s co_mmo^du^s e^ti&a&m si& e^a&t mo&le_stu^s e&st	X_X^^X_X_X_^X	m
Quid inde agam nescio. Ne vero non feram	qui&d i_nde& a^ga&m ne_sci^o^. ne_ ve_ro& no&n fe^ra&m 	X_X_X^^X_X_^X	v
nati ad parentem immane discrimen sui,	na&ti& a&d pa&re_nte&m i&mma_ne& di_scri&me&n su^i& 	X_X_X_X_X_^X	1.0
ut, siquid opis habet, peroccurrat malis?	u&t si_qvi&d o^pi^s ha&be&t pe&ro_ccu&rra&t ma^li&s 	X_X^^X_X_X_^X	m
Et quid is Hyempsalis haesitans venit puer?	e&t qvi^d i^s hy&e_mpsa^li^s h[ae]si&ta_ns ve&ni&t pu^e&r 	X^^X_^^_X_X_^X	1.0
Tibi filium gravi in periclo nuncio,	ti^bi^ fi_li&u&m gra&vi& i&n pe&ri_clo& nu_nci^o& 	^^_X_X_X_X_^X	0.85
o mater, esse. Nanque noctu vi aedium	o& ma_te&r e_sse& na_nqve& no_ctu& vi& [ae]di^u&m 	X_X_X_X_X_^X	1.0
fractis foribus intro satellites globis	fra&cti&s fo&ri^bu^s i&ntro_ sa&te_lli&te&s glo^bi&s	X_X^^X_X_X_^X	m
quaque irruentes vulnere et caede et lue	qva&qve& i_rru&e_nte&s vu_lne&re& e&t c[ae]de& e&t lu^e& 	X_X_X_X_X_^X	1.0
totam penitus Hyempsalis vexant domum.	to&ta&m pe&ni^tu^s hy&e_mpsa&li&s ve&xa&nt do^mu&m	X_X^^X_X_X_^X	m
Stant lubrici undantesque scalarum omnium	sta&nt lu_bri^ci& u_nda_nte_sque^ sca_la&ru&m o_mni^u&m 	X_X_X_X_X_^X	v
cruore fuso alte gradus ac undique	cru&o_re& fu_so& a&lte& gra&du_s a&c u_ndi^qve& 	X_X_X_X_X_^X	0.94
strepitu atque fremitu tecta et una omnis domus	stre^pi^tu& a_tqve& fre^mi^tu& te_cta& e&t u_na& o&mni&s do^mu&s 	^^_X^^X_X_X_^X	1.0
tremit et suum strage intus atra congemit.	tre^mi^t e&t su&u&m stra&ge& i_ntu&s a_tra& co_nge^mi&t 	^^_X_X_X_X_^X	1.0
At sibi suis non prorsus iratis diis:	a&t si^bi^ su&i&s no&n pro_rsu&s i_ra&ti&s di^i&s 	X^^X_X_X_X_^X	0.81
cadentium ex cumulis Hyempsal diffugit.	ca^de_nti^u&m e&x cu^mu^li&s hy^e_mpsa&l di_ffu^gi&t. 	X_X_^^_X_X_^X	m
Tu, mater, his praesentibus rebus metu	tu& ma_te&r hi&s pr[ae]se_nti&bu&s re&bu&s me^tu& 	X_X_X_X_X_^X	1.0
luctuque secluso tibique consule.	lu&ctu_qve& se_clu&so_ ti&bi_qve& co_nsu^le& 	X_X_X_X_X_^X	0.15
Oe miseram matrem! Sed eccum et alterum	o&e^ mi^se^ra&m ma_tre&m! se^d e_ccu&m e&t a_lte^ru&m 	X^^X_X_X_X_^X	m
Hyempsalis properantem et anxium intimum.	hy&e_mpsa&li_s pro^pe^ra_nte&m e&t a_nxi&u&m i_nti^mu&m 	X_X_^^_X_X_^X	1.0
O tempora, o mores! Ita ne frater necem	o_ te_mpo^ra&, o_ mo_re_s! i^ta^ ne^ fra_te&r ne^ce&m 	X_X_X_X^^X_^X	m
fratri parat? Ubi nam, ubi erit, o cives, fides?	fra&tri_ pa&ra^t u^bi& na&m u^bi& e^ri&t o_ ci&ve&s fi^de&s 	X_X^^X^^X_X_^X	1.0
Ubi pietas apud homines tandem sita,	u&bi^ pi^e&ta_s a&pu^d ho^mi&ne&s ta&nde&m si^ta& 	X^^X_X^^X_X_^X	m
hanc si integram non iura servant sanguinis?	ha&nc si& i_nte&gra&m no&n ju_ra& se_rva&nt sa_ngvi^ni&s 	X_X_X_X_X_^X	1.0
Tibi, o miserrima omnium mater, tuos	ti&bi& o_ mi&se_rri&ma& o_mni&u&m ma&te&r tu^o&s 	X_X_X_X_X_^X	1.0
unde aut inibis aut acerbos finies	u_nde [au]t i^ni_bi&s [au]t a^ce_rbo&s fi_ni^e&s 	X_X_X_X_X_^X	m
luctus? Quid et tu denique apportas mali?	lu&ctu&s qvi&d e&t tu& de_ni&qve& a_ppo&rta_s ma^li& 	X_X_X_X_X_^X	0.82
Iugurtha herum ferro he extinxit meum.	iu&gu_rtha& he^ru&m fe_rro_ he^ e_xti_nxi&t me^u&m. 	X_X_X_X_X_^X	m
He he he! Adeste, accurrite, he succedite,	he^ he^ he^! a^de_ste&, a_ccu_rri^te^, he^ su_cce_di^te&, 	X^^X_X_X^^X_^X	m
lapsamque prae dolore et exanguem solo	la&psa_mqve& pr[ae] do&lo_re& e&t e_xa&ngve&m so^lo& 	X_X_X_X_X_^X	0.71
stratam parentem tollite hanc in regiam	stra&ta&m pa&re_nte&m to_lli&te& ha&nc i&n re_gi^a&m 	X_X_X_X_X_^X	1.0
funestam et infaustam domum. Vos, o probi	fu&ne_sta&m e&t i_nf[au]sta&m do&mu&m vo&s o& pro^bi& 	X_X_X_X_X_^X	1.0
cives, bonis fatis, bonis et moribus,	ci&ve&s bo&ni&s fa&ti&s bo&ni_s e&t mo_ri^bu&s 	X_X_X_X_X_^X	1.0
iam bene valete, et quid nefandum ac pestilens	ja&m be^ne^ va&le_te& e&t qvi&d ne&fa_ndu&m a&c pe_sti^le&ns 	X^^X_X_X_X_^X	1.0
malum invidia possit per haec agnoscite.	ma&lu&m i_nvi&di^a^ po&ssi&t pe&r h[ae]c a&gno_sci^te& 	X_X^^X_X_X_^X	m
